Time,Date,Day of the week,CarCount,BikeCount,BusCount,TruckCount,Total,Traffic Situation
0:00,10,Tuesday,31,0,4,4,39,low
0:15,10,Tuesday,49,0,3,3,55,low
0:30,10,Tuesday,46,0,3,6,55,low
0:45,10,Tuesday,51,0,2,5,58,low
1:00,10,Tuesday,57,6,15,16,94,normal
1:15,10,Tuesday,44,0,5,4,53,low
1:30,10,Tuesday,37,0,1,4,42,low
1:45,10,Tuesday,42,4,4,5,55,low
2:00,10,Tuesday,51,0,9,7,67,low
2:15,10,Tuesday,34,0,4,7,45,low
2:30,10,Tuesday,45,0,1,1,47,low
2:45,10,Tuesday,45,0,1,3,49,low
3:00,10,Tuesday,50,0,3,0,53,low
3:15,10,Tuesday,34,0,4,4,42,low
3:30,10,Tuesday,129,22,42,1,194,heavy
3:45,10,Tuesday,144,16,49,0,209,heavy
4:00,10,Tuesday,111,28,20,3,162,normal
4:15,10,Tuesday,67,11,10,16,104,normal
4:30,10,Tuesday,65,24,7,16,112,normal
4:45,10,Tuesday,94,27,7,16,144,normal
5:00,10,Tuesday,94,20,8,7,129,normal
5:15,10,Tuesday,67,29,5,10,111,low
5:30,10,Tuesday,56,12,2,14,84,normal
5:45,10,Tuesday,57,13,3,11,84,low
6:00,10,Tuesday,129,22,42,1,194,heavy
6:15,10,Tuesday,144,16,49,0,209,heavy
6:30,10,Tuesday,111,28,20,3,162,normal
6:45,10,Tuesday,120,27,46,3,196,heavy
7:00,10,Tuesday,102,39,47,1,189,heavy
7:15,10,Tuesday,145,23,27,0,195,heavy
7:30,10,Tuesday,114,37,21,5,177,heavy
7:45,10,Tuesday,108,18,22,1,149,normal
8:00,10,Tuesday,122,28,33,1,184,heavy
8:15,10,Tuesday,114,39,30,3,186,heavy
8:30,10,Tuesday,150,36,25,1,212,heavy
8:45,10,Tuesday,107,10,49,2,168,heavy
9:00,10,Tuesday,124,24,22,0,170,heavy
9:15,10,Tuesday,77,16,39,29,161,high
9:30,10,Tuesday,15,23,30,21,89,normal
9:45,10,Tuesday,32,22,38,21,113,high
10:00,10,Tuesday,68,13,29,24,134,high
10:15,10,Tuesday,27,16,36,30,109,normal
10:30,10,Tuesday,76,7,11,15,109,normal
10:45,10,Tuesday,41,23,20,17,101,normal
11:00,10,Tuesday,33,10,3,29,75,normal
11:15,10,Tuesday,58,8,14,29,109,normal
11:30,10,Tuesday,65,7,11,26,109,normal
11:45,10,Tuesday,47,9,6,29,91,normal
12:00,10,Tuesday,38,10,5,25,78,normal
12:15,10,Tuesday,57,8,12,29,106,normal
12:30,10,Tuesday,20,6,4,20,50,normal
12:45,10,Tuesday,24,9,14,23,70,normal
13:00,10,Tuesday,52,10,13,21,96,normal
13:15,10,Tuesday,79,15,36,18,148,high
13:30,10,Tuesday,84,24,22,18,148,normal
13:45,10,Tuesday,59,19,35,16,129,high
14:00,10,Tuesday,88,26,31,19,164,high
14:15,10,Tuesday,24,11,32,13,80,normal
14:30,10,Tuesday,110,17,23,20,170,heavy
14:45,10,Tuesday,29,26,5,6,66,low
15:00,10,Tuesday,43,26,11,20,100,normal
15:15,10,Tuesday,68,28,9,15,120,normal
15:30,10,Tuesday,108,16,8,18,150,normal
15:45,10,Tuesday,101,26,8,14,149,normal
16:00,10,Tuesday,141,31,36,6,214,heavy
16:15,10,Tuesday,120,25,28,5,178,heavy
16:30,10,Tuesday,137,23,44,5,209,heavy
16:45,10,Tuesday,124,11,30,7,172,heavy
17:00,10,Tuesday,145,25,49,7,226,heavy
17:15,10,Tuesday,122,37,23,8,190,heavy
17:30,10,Tuesday,136,30,20,9,195,heavy
17:45,10,Tuesday,145,18,40,9,212,heavy
18:00,10,Tuesday,138,34,28,5,205,heavy
18:15,10,Tuesday,123,10,29,8,170,heavy
18:30,10,Tuesday,105,15,21,9,150,normal
18:45,10,Tuesday,75,22,20,11,128,normal
19:00,10,Tuesday,90,12,10,13,125,normal
19:15,10,Tuesday,102,22,20,16,160,normal
19:30,10,Tuesday,61,18,15,27,121,high
19:45,10,Tuesday,70,8,14,6,98,low
20:00,10,Tuesday,80,17,12,34,143,high
20:15,10,Tuesday,62,12,14,19,107,normal
20:30,10,Tuesday,96,5,11,13,125,normal
20:45,10,Tuesday,102,6,12,13,133,normal
21:00,10,Tuesday,91,14,15,6,126,normal
21:15,10,Tuesday,95,8,17,13,133,normal
21:30,10,Tuesday,75,15,12,21,123,high
21:45,10,Tuesday,53,21,20,10,104,normal
22:00,10,Tuesday,13,1,0,19,33,normal
22:15,10,Tuesday,10,0,1,24,35,normal
22:30,10,Tuesday,16,2,0,33,51,normal
22:45,10,Tuesday,11,1,0,29,41,normal
23:00,10,Tuesday,18,2,1,13,34,normal
23:15,10,Tuesday,15,0,1,11,27,low
23:30,10,Tuesday,14,1,0,33,48,normal
23:45,10,Tuesday,17,2,0,22,41,normal
0:00,11,Wednesday,12,2,1,17,32,normal
0:15,11,Wednesday,18,0,0,29,47,normal
0:30,11,Wednesday,16,1,0,14,31,normal
0:45,11,Wednesday,20,0,0,14,34,normal
1:00,11,Wednesday,20,1,1,30,52,normal
1:15,11,Wednesday,15,0,1,23,39,normal
1:30,11,Wednesday,16,0,1,26,43,normal
1:45,11,Wednesday,18,4,0,11,33,low
2:00,11,Wednesday,17,3,1,36,57,normal
2:15,11,Wednesday,14,4,1,10,29,low
2:30,11,Wednesday,18,2,1,25,46,normal
2:45,11,Wednesday,12,2,0,19,33,normal
3:00,11,Wednesday,11,4,0,30,45,normal
3:15,11,Wednesday,19,1,1,36,57,normal
3:30,11,Wednesday,10,4,0,36,50,normal
3:45,11,Wednesday,20,1,1,32,54,normal
4:00,11,Wednesday,15,5,1,40,61,normal
4:15,11,Wednesday,104,6,5,1,116,normal
4:30,11,Wednesday,109,25,3,8,145,normal
4:45,11,Wednesday,82,23,8,20,133,normal
5:00,11,Wednesday,81,25,1,18,125,normal
5:15,11,Wednesday,95,16,10,1,122,normal
5:30,11,Wednesday,91,24,7,6,128,normal
5:45,11,Wednesday,81,30,10,0,121,normal
6:00,11,Wednesday,125,13,26,2,166,high
6:15,11,Wednesday,125,39,49,3,216,heavy
6:30,11,Wednesday,125,34,37,1,197,heavy
6:45,11,Wednesday,125,19,25,4,173,heavy
7:00,11,Wednesday,125,15,49,0,189,heavy
7:15,11,Wednesday,125,32,50,5,212,heavy
7:30,11,Wednesday,125,38,50,1,214,heavy
7:45,11,Wednesday,125,29,29,3,186,heavy
8:00,11,Wednesday,125,31,48,4,208,heavy
8:15,11,Wednesday,125,32,50,0,207,heavy
8:30,11,Wednesday,125,31,45,0,201,heavy
8:45,11,Wednesday,125,21,20,1,167,normal
9:00,11,Wednesday,125,28,36,0,189,heavy
9:15,11,Wednesday,39,10,37,16,102,normal
9:30,11,Wednesday,89,8,12,13,122,normal
9:45,11,Wednesday,51,16,16,13,96,normal
10:00,11,Wednesday,17,9,18,28,72,normal
10:15,11,Wednesday,48,25,36,21,130,high
10:30,11,Wednesday,93,7,30,16,146,high
10:45,11,Wednesday,55,15,36,15,121,high
11:00,11,Wednesday,51,10,8,22,91,normal
11:15,11,Wednesday,51,7,3,24,85,normal
11:30,11,Wednesday,51,9,7,30,97,normal
11:45,11,Wednesday,51,7,14,20,92,normal
12:00,11,Wednesday,51,10,14,20,95,normal
12:15,11,Wednesday,51,10,6,22,89,normal
12:30,11,Wednesday,51,8,11,22,92,normal
12:45,11,Wednesday,51,6,10,26,93,normal
13:00,11,Wednesday,51,7,7,27,92,normal
13:15,11,Wednesday,104,17,25,20,166,normal
13:30,11,Wednesday,6,28,27,14,75,normal
13:45,11,Wednesday,54,29,37,9,129,high
14:00,11,Wednesday,43,13,30,20,106,normal
14:15,11,Wednesday,60,21,26,11,118,high
14:30,11,Wednesday,101,23,8,20,152,normal
14:45,11,Wednesday,62,26,19,11,118,normal
15:00,11,Wednesday,39,24,13,11,87,low
15:15,11,Wednesday,90,20,35,7,152,high
15:30,11,Wednesday,109,30,22,20,181,heavy
15:45,11,Wednesday,68,26,25,20,139,normal
16:00,11,Wednesday,142,22,37,6,207,heavy
16:15,11,Wednesday,113,14,20,5,152,normal
16:30,11,Wednesday,142,13,37,8,200,heavy
16:45,11,Wednesday,108,23,26,9,166,high
17:00,11,Wednesday,122,29,30,7,188,heavy
17:15,11,Wednesday,133,12,30,7,182,heavy
17:30,11,Wednesday,118,23,38,10,189,heavy
17:45,11,Wednesday,121,35,26,8,190,heavy
18:00,11,Wednesday,116,23,20,8,167,normal
18:15,11,Wednesday,132,12,27,8,179,heavy
18:30,11,Wednesday,144,17,33,7,201,heavy
18:45,11,Wednesday,103,21,11,11,146,normal
19:00,11,Wednesday,107,15,10,15,147,normal
19:15,11,Wednesday,50,10,10,17,87,normal
19:30,11,Wednesday,108,15,10,6,139,normal
19:45,11,Wednesday,108,24,15,29,176,heavy
20:00,11,Wednesday,101,6,15,13,135,normal
20:15,11,Wednesday,55,17,12,19,103,normal
20:30,11,Wednesday,77,7,20,16,120,normal
20:45,11,Wednesday,91,12,19,8,130,normal
21:00,11,Wednesday,95,25,17,29,166,high
21:15,11,Wednesday,78,17,17,27,139,high
21:30,11,Wednesday,98,16,16,21,151,high
21:45,11,Wednesday,86,13,11,35,145,high
22:00,11,Wednesday,18,4,0,16,38,normal
22:15,11,Wednesday,18,5,0,12,35,low
22:30,11,Wednesday,18,2,1,25,46,normal
22:45,11,Wednesday,18,1,0,17,36,normal
23:00,11,Wednesday,18,5,0,21,44,normal
23:15,11,Wednesday,18,0,1,12,31,low
23:30,11,Wednesday,18,3,1,28,50,normal
23:45,11,Wednesday,18,4,1,40,63,normal
0:00,12,Thursday,18,1,1,39,59,normal
0:15,12,Thursday,18,4,0,30,52,normal
0:30,12,Thursday,18,5,1,13,37,normal
0:45,12,Thursday,18,2,0,37,57,normal
1:00,12,Thursday,18,0,0,13,31,normal
1:15,12,Thursday,18,5,0,11,34,low
1:30,12,Thursday,18,5,1,12,36,low
1:45,12,Thursday,18,1,1,16,36,normal
2:00,12,Thursday,18,1,1,34,54,normal
2:15,12,Thursday,18,1,0,24,43,normal
2:30,12,Thursday,18,0,0,23,41,normal
2:45,12,Thursday,18,0,0,27,45,normal
3:00,12,Thursday,18,5,0,28,51,normal
3:15,12,Thursday,18,1,0,14,33,normal
3:30,12,Thursday,18,5,0,25,48,normal
3:45,12,Thursday,18,4,1,30,53,normal
4:00,12,Thursday,18,5,1,30,54,normal
4:15,12,Thursday,62,24,7,2,95,low
4:30,12,Thursday,51,23,6,1,81,low
4:45,12,Thursday,114,23,10,19,166,normal
5:00,12,Thursday,85,22,9,9,125,normal
5:15,12,Thursday,102,24,4,20,150,normal
5:30,12,Thursday,101,18,3,17,139,normal
5:45,12,Thursday,116,19,0,17,152,normal
6:00,12,Thursday,117,38,50,5,210,heavy
6:15,12,Thursday,114,32,34,2,182,heavy
6:30,12,Thursday,120,17,23,1,161,normal
6:45,12,Thursday,145,20,25,2,192,heavy
7:00,12,Thursday,125,30,48,1,204,heavy
7:15,12,Thursday,103,27,45,1,176,heavy
7:30,12,Thursday,114,20,43,1,178,heavy
7:45,12,Thursday,145,10,44,1,200,heavy
8:00,12,Thursday,147,31,20,4,202,heavy
8:15,12,Thursday,104,24,40,0,168,heavy
8:30,12,Thursday,124,11,22,0,157,normal
8:45,12,Thursday,101,37,31,4,173,heavy
9:00,12,Thursday,144,30,37,1,212,heavy
9:15,12,Thursday,24,18,37,18,97,normal
9:30,12,Thursday,24,8,17,25,74,normal
9:45,12,Thursday,16,22,12,20,70,normal
10:00,12,Thursday,26,2,39,26,93,normal
10:15,12,Thursday,90,7,18,15,130,normal
10:30,12,Thursday,59,6,11,11,87,low
10:45,12,Thursday,28,7,22,18,75,normal
11:00,12,Thursday,60,5,14,21,100,normal
11:15,12,Thursday,69,9,8,23,109,normal
11:30,12,Thursday,59,9,12,26,106,normal
11:45,12,Thursday,24,10,5,21,60,normal
12:00,12,Thursday,41,7,7,21,76,normal
12:15,12,Thursday,48,10,9,29,96,normal
12:30,12,Thursday,59,10,14,23,106,normal
12:45,12,Thursday,67,7,12,28,114,high
13:00,12,Thursday,52,9,8,20,89,normal
13:15,12,Thursday,45,26,29,10,110,normal
13:30,12,Thursday,14,21,7,18,60,normal
13:45,12,Thursday,55,22,24,10,111,normal
14:00,12,Thursday,45,14,39,5,103,normal
14:15,12,Thursday,90,17,16,11,134,normal
14:30,12,Thursday,33,21,25,5,84,normal
14:45,12,Thursday,118,25,31,13,187,heavy
15:00,12,Thursday,86,28,13,5,132,normal
15:15,12,Thursday,105,29,22,12,168,heavy
15:30,12,Thursday,10,19,26,8,63,normal
15:45,12,Thursday,46,22,18,9,95,normal
16:00,12,Thursday,105,35,48,6,194,heavy
16:15,12,Thursday,135,37,34,5,211,heavy
16:30,12,Thursday,103,29,44,6,182,heavy
16:45,12,Thursday,113,13,42,10,178,heavy
17:00,12,Thursday,103,20,27,9,159,high
17:15,12,Thursday,150,13,20,9,192,heavy
17:30,12,Thursday,116,25,33,8,182,heavy
17:45,12,Thursday,109,16,41,9,175,heavy
18:00,12,Thursday,112,11,50,5,178,heavy
18:15,12,Thursday,104,31,30,5,170,heavy
18:30,12,Thursday,146,18,40,6,210,heavy
18:45,12,Thursday,110,24,10,29,173,heavy
19:00,12,Thursday,60,15,12,25,112,high
19:15,12,Thursday,103,9,14,29,155,high
19:30,12,Thursday,102,6,15,6,129,normal
19:45,12,Thursday,51,17,16,8,92,normal
20:00,12,Thursday,62,12,11,18,103,normal
20:15,12,Thursday,103,14,12,5,134,normal
20:30,12,Thursday,50,7,11,23,91,normal
20:45,12,Thursday,80,14,20,6,120,normal
21:00,12,Thursday,98,13,18,21,150,high
21:15,12,Thursday,53,25,20,13,111,normal
21:30,12,Thursday,52,8,10,27,97,normal
21:45,12,Thursday,71,23,13,21,128,high
22:00,12,Thursday,17,3,0,29,49,normal
22:15,12,Thursday,20,5,1,36,62,normal
22:30,12,Thursday,15,0,0,32,47,normal
22:45,12,Thursday,15,0,1,20,36,normal
23:00,12,Thursday,14,2,0,23,39,normal
23:15,12,Thursday,13,1,0,29,43,normal
23:30,12,Thursday,14,5,0,31,50,normal
23:45,12,Thursday,16,3,0,33,52,normal
0:00,13,Friday,18,4,1,15,38,normal
0:15,13,Friday,20,0,1,23,44,normal
0:30,13,Friday,19,3,0,16,38,normal
0:45,13,Friday,10,3,0,12,25,low
1:00,13,Friday,10,4,0,23,37,normal
1:15,13,Friday,12,5,0,29,46,normal
1:30,13,Friday,10,0,0,39,49,normal
1:45,13,Friday,16,2,1,21,40,normal
2:00,13,Friday,18,4,1,36,59,normal
2:15,13,Friday,15,1,0,14,30,normal
2:30,13,Friday,17,4,0,13,34,normal
2:45,13,Friday,18,3,1,24,46,normal
3:00,13,Friday,19,2,0,11,32,low
3:15,13,Friday,19,3,0,21,43,normal
3:30,13,Friday,19,3,1,31,54,normal
3:45,13,Friday,14,2,1,19,36,normal
4:00,13,Friday,11,0,0,27,38,normal
4:15,13,Friday,27,6,1,11,45,low
4:30,13,Friday,33,11,6,13,63,normal
4:45,13,Friday,63,6,7,10,86,low
5:00,13,Friday,58,13,4,15,90,normal
5:15,13,Friday,57,11,7,10,85,low
5:30,13,Friday,63,10,6,12,91,low
5:45,13,Friday,74,9,0,15,98,normal
6:00,13,Friday,71,9,7,10,97,low
6:15,13,Friday,33,9,6,13,61,normal
6:30,13,Friday,29,6,1,12,48,low
6:45,13,Friday,32,9,3,11,55,low
7:00,13,Friday,57,14,3,11,85,low
7:15,13,Friday,31,11,0,14,56,normal
7:30,13,Friday,30,9,3,10,52,low
7:45,13,Friday,61,8,7,12,88,low
8:00,13,Friday,47,10,4,10,71,low
8:15,13,Friday,80,16,4,15,115,normal
8:30,13,Friday,49,10,2,10,71,low
8:45,13,Friday,58,7,5,13,83,normal
9:00,13,Friday,53,19,1,10,83,low
9:15,13,Friday,132,47,25,0,204,heavy
9:30,13,Friday,131,52,15,0,198,heavy
9:45,13,Friday,171,59,27,3,260,heavy
10:00,13,Friday,131,43,20,3,197,heavy
10:15,13,Friday,177,56,12,4,249,heavy
10:30,13,Friday,160,47,30,3,240,heavy
10:45,13,Friday,178,68,28,4,278,heavy
11:00,13,Friday,169,70,20,3,262,heavy
11:15,13,Friday,133,56,25,2,216,heavy
11:30,13,Friday,151,52,13,0,216,heavy
11:45,13,Friday,179,46,27,3,255,heavy
12:00,13,Friday,144,68,20,0,232,heavy
12:15,13,Friday,162,46,19,2,229,heavy
12:30,13,Friday,159,44,23,2,228,heavy
12:45,13,Friday,174,67,30,1,272,heavy
13:00,13,Friday,136,57,29,4,226,heavy
13:15,13,Friday,156,42,12,3,213,heavy
13:30,13,Friday,175,63,19,3,260,heavy
13:45,13,Friday,172,62,20,2,256,heavy
14:00,13,Friday,171,49,15,0,235,heavy
14:15,13,Friday,172,65,18,2,257,heavy
14:30,13,Friday,176,50,13,1,240,heavy
14:45,13,Friday,153,50,23,3,229,heavy
15:00,13,Friday,148,64,27,0,239,heavy
15:15,13,Friday,56,28,6,2,92,low
15:30,13,Friday,88,26,25,0,139,normal
15:45,13,Friday,82,23,14,0,119,normal
16:00,13,Friday,77,20,7,0,104,low
16:15,13,Friday,66,24,1,0,91,low
16:30,13,Friday,72,22,8,2,104,low
16:45,13,Friday,62,28,21,2,113,normal
17:00,13,Friday,66,26,4,1,97,low
17:15,13,Friday,85,20,4,0,109,low
17:30,13,Friday,87,24,11,2,124,normal
17:45,13,Friday,67,28,25,0,120,normal
18:00,13,Friday,70,26,16,2,114,normal
18:15,13,Friday,62,20,20,1,103,normal
18:30,13,Friday,67,29,1,0,97,low
18:45,13,Friday,65,25,1,1,92,low
19:00,13,Friday,76,24,23,0,123,normal
19:15,13,Friday,42,1,5,11,59,low
19:30,13,Friday,42,10,3,1,56,low
19:45,13,Friday,31,11,1,12,55,low
20:00,13,Friday,47,7,3,6,63,low
20:15,13,Friday,28,7,2,4,41,low
20:30,13,Friday,22,3,6,1,32,low
20:45,13,Friday,29,1,7,5,42,low
21:00,13,Friday,43,9,1,11,64,low
21:15,13,Friday,23,3,3,8,37,low
21:30,13,Friday,21,2,5,15,43,normal
21:45,13,Friday,31,2,1,9,43,low
22:00,13,Friday,15,5,0,18,38,normal
22:15,13,Friday,11,2,0,15,28,normal
22:30,13,Friday,12,0,1,17,30,normal
22:45,13,Friday,18,3,0,18,39,normal
23:00,13,Friday,19,1,0,31,51,normal
23:15,13,Friday,17,0,0,22,39,normal
23:30,13,Friday,15,5,0,14,34,normal
23:45,13,Friday,15,1,1,24,41,normal
0:00,14,Saturday,18,4,0,33,55,normal
0:15,14,Saturday,14,4,0,34,52,normal
0:30,14,Saturday,14,0,1,19,34,normal
0:45,14,Saturday,19,3,0,36,58,normal
1:00,14,Saturday,10,4,1,21,36,normal
1:15,14,Saturday,19,1,0,19,39,normal
1:30,14,Saturday,18,5,0,26,49,normal
1:45,14,Saturday,17,1,1,25,44,normal
2:00,14,Saturday,20,2,0,12,34,low
2:15,14,Saturday,15,5,0,15,35,normal
2:30,14,Saturday,11,4,0,14,29,normal
2:45,14,Saturday,14,3,1,18,36,normal
3:00,14,Saturday,13,2,0,39,54,normal
3:15,14,Saturday,17,5,0,29,51,normal
3:30,14,Saturday,13,5,0,31,49,normal
3:45,14,Saturday,18,5,0,35,58,normal
4:00,14,Saturday,15,4,0,16,35,normal
4:15,14,Saturday,55,15,5,3,78,low
4:30,14,Saturday,76,10,7,9,102,low
4:45,14,Saturday,98,0,9,19,126,normal
5:00,14,Saturday,98,12,6,6,122,normal
5:15,14,Saturday,103,2,10,20,135,normal
5:30,14,Saturday,93,17,8,12,130,normal
5:45,14,Saturday,115,27,9,16,167,normal
6:00,14,Saturday,120,12,22,3,157,normal
6:15,14,Saturday,142,18,27,0,187,heavy
6:30,14,Saturday,117,29,49,2,197,heavy
6:45,14,Saturday,126,36,24,0,186,heavy
7:00,14,Saturday,110,39,38,5,192,heavy
7:15,14,Saturday,149,20,39,5,213,heavy
7:30,14,Saturday,109,29,23,5,166,normal
7:45,14,Saturday,124,34,24,4,186,heavy
8:00,14,Saturday,149,35,32,1,217,heavy
8:15,14,Saturday,125,32,38,4,199,heavy
8:30,14,Saturday,101,23,38,1,163,high
8:45,14,Saturday,137,36,30,0,203,heavy
9:00,14,Saturday,139,15,21,3,178,heavy
9:15,14,Saturday,19,3,29,9,60,normal
9:30,14,Saturday,13,11,39,7,70,normal
9:45,14,Saturday,31,2,29,27,89,normal
10:00,14,Saturday,18,24,21,22,85,normal
10:15,14,Saturday,26,12,14,13,65,normal
10:30,14,Saturday,31,15,13,28,87,normal
10:45,14,Saturday,12,22,8,11,53,low
11:00,14,Saturday,54,5,13,23,95,normal
11:15,14,Saturday,59,7,13,21,100,normal
11:30,14,Saturday,58,8,6,23,95,normal
11:45,14,Saturday,53,8,9,25,95,normal
12:00,14,Saturday,54,7,7,20,88,normal
12:15,14,Saturday,39,10,4,29,82,normal
12:30,14,Saturday,38,9,8,22,77,normal
12:45,14,Saturday,36,5,10,23,74,normal
13:00,14,Saturday,68,6,12,24,110,normal
13:15,14,Saturday,50,18,26,14,108,normal
13:30,14,Saturday,120,28,22,20,190,heavy
13:45,14,Saturday,60,14,28,9,111,normal
14:00,14,Saturday,105,14,8,19,146,normal
14:15,14,Saturday,89,27,18,8,142,normal
14:30,14,Saturday,28,17,31,10,86,normal
14:45,14,Saturday,79,14,23,6,122,normal
15:00,14,Saturday,15,11,30,14,70,normal
15:15,14,Saturday,77,27,23,18,145,normal
15:30,14,Saturday,19,14,24,6,63,normal
15:45,14,Saturday,79,13,28,7,127,high
16:00,14,Saturday,114,10,22,9,155,normal
16:15,14,Saturday,150,30,22,5,207,heavy
16:30,14,Saturday,142,23,25,7,197,heavy
16:45,14,Saturday,111,36,25,6,178,heavy
17:00,14,Saturday,143,37,38,8,226,heavy
17:15,14,Saturday,120,37,43,10,210,heavy
17:30,14,Saturday,147,20,49,7,223,normal
17:45,14,Saturday,140,22,27,5,194,heavy
18:00,14,Saturday,128,37,20,9,194,heavy
18:15,14,Saturday,114,23,42,10,189,heavy
18:30,14,Saturday,117,20,22,9,168,heavy
18:45,14,Saturday,93,24,17,23,157,high
19:00,14,Saturday,65,15,15,8,103,low
19:15,14,Saturday,100,22,14,8,144,normal
19:30,14,Saturday,85,12,11,18,126,normal
19:45,14,Saturday,56,7,12,12,87,low
20:00,14,Saturday,50,12,15,18,95,normal
20:15,14,Saturday,74,9,11,12,106,low
20:30,14,Saturday,73,15,18,7,113,normal
20:45,14,Saturday,99,13,20,30,162,high
21:00,14,Saturday,110,14,17,8,149,normal
21:15,14,Saturday,82,5,12,34,133,high
21:30,14,Saturday,58,19,12,17,106,normal
21:45,14,Saturday,70,10,14,32,126,high
22:00,14,Saturday,10,1,0,33,44,normal
22:15,14,Saturday,14,1,1,40,56,normal
22:30,14,Saturday,17,1,1,17,36,normal
22:45,14,Saturday,12,4,1,22,39,normal
23:00,14,Saturday,15,0,0,16,31,normal
23:15,14,Saturday,13,4,0,25,42,normal
23:30,14,Saturday,14,5,1,12,32,low
23:45,14,Saturday,18,1,1,35,55,normal
0:00,15,Sunday,18,5,1,19,43,normal
0:15,15,Sunday,19,3,0,38,60,normal
0:30,15,Sunday,13,0,1,12,26,low
0:45,15,Sunday,20,0,1,38,59,normal
1:00,15,Sunday,20,1,1,24,46,normal
1:15,15,Sunday,17,3,1,17,38,normal
1:30,15,Sunday,12,3,1,35,51,normal
1:45,15,Sunday,19,0,1,30,50,normal
2:00,15,Sunday,19,2,1,30,52,normal
2:15,15,Sunday,18,1,0,16,35,normal
2:30,15,Sunday,11,0,0,31,42,normal
2:45,15,Sunday,10,1,1,12,24,low
3:00,15,Sunday,16,1,0,24,41,normal
3:15,15,Sunday,18,3,0,28,49,normal
3:30,15,Sunday,20,1,1,39,61,normal
3:45,15,Sunday,19,3,1,27,50,normal
4:00,15,Sunday,14,1,1,34,50,normal
4:15,15,Sunday,61,26,1,16,104,normal
4:30,15,Sunday,72,26,6,4,108,low
4:45,15,Sunday,86,24,3,18,131,normal
5:00,15,Sunday,75,1,8,10,94,low
5:15,15,Sunday,75,1,7,9,92,low
5:30,15,Sunday,93,5,4,1,103,low
5:45,15,Sunday,111,6,2,5,124,normal
6:00,15,Sunday,111,18,41,2,172,heavy
6:15,15,Sunday,114,27,46,0,187,heavy
6:30,15,Sunday,139,19,50,2,210,heavy
6:45,15,Sunday,109,14,38,1,162,high
7:00,15,Sunday,105,16,22,3,146,normal
7:15,15,Sunday,150,13,31,4,198,heavy
7:30,15,Sunday,122,13,47,3,185,heavy
7:45,15,Sunday,114,24,46,2,186,heavy
8:00,15,Sunday,119,36,41,0,196,heavy
8:15,15,Sunday,108,35,39,0,182,heavy
8:30,15,Sunday,113,18,28,1,160,high
8:45,15,Sunday,118,36,37,0,191,heavy
9:00,15,Sunday,113,35,48,3,199,heavy
9:15,15,Sunday,66,7,22,30,125,high
9:30,15,Sunday,64,12,27,8,111,normal
9:45,15,Sunday,37,5,13,11,66,low
10:00,15,Sunday,82,17,31,20,150,high
10:15,15,Sunday,63,5,23,12,103,normal
10:30,15,Sunday,20,12,16,24,72,normal
10:45,15,Sunday,46,5,34,9,94,normal
11:00,15,Sunday,35,9,8,29,81,normal
11:15,15,Sunday,33,9,11,21,74,normal
11:30,15,Sunday,32,9,10,30,81,normal
11:45,15,Sunday,62,10,6,22,100,normal
12:00,15,Sunday,62,10,11,22,105,normal
12:15,15,Sunday,54,10,12,25,101,normal
12:30,15,Sunday,48,8,15,23,94,normal
12:45,15,Sunday,20,10,12,24,66,normal
13:00,15,Sunday,35,10,5,30,80,normal
13:15,15,Sunday,112,15,40,10,177,heavy
13:30,15,Sunday,51,21,25,13,110,normal
13:45,15,Sunday,53,12,23,8,96,normal
14:00,15,Sunday,63,22,18,15,118,normal
14:15,15,Sunday,50,23,16,8,97,normal
14:30,15,Sunday,94,20,35,17,166,high
14:45,15,Sunday,7,27,39,17,90,normal
15:00,15,Sunday,109,18,13,6,146,normal
15:15,15,Sunday,18,27,19,6,70,normal
15:30,15,Sunday,21,30,5,5,61,low
15:45,15,Sunday,49,16,9,12,86,low
16:00,15,Sunday,129,28,40,6,203,heavy
16:15,15,Sunday,141,18,28,8,195,heavy
16:30,15,Sunday,131,14,43,7,195,heavy
16:45,15,Sunday,105,38,23,5,171,heavy
17:00,15,Sunday,125,35,37,5,202,heavy
17:15,15,Sunday,127,36,42,9,214,heavy
17:30,15,Sunday,129,22,25,9,185,heavy
17:45,15,Sunday,121,39,47,8,215,heavy
18:00,15,Sunday,138,29,42,9,218,heavy
18:15,15,Sunday,119,26,21,5,171,heavy
18:30,15,Sunday,138,17,48,8,211,heavy
18:45,15,Sunday,72,12,14,32,130,high
19:00,15,Sunday,92,23,20,30,165,high
19:15,15,Sunday,94,17,11,24,146,high
19:30,15,Sunday,102,25,12,24,163,high
19:45,15,Sunday,71,23,17,14,125,normal
20:00,15,Sunday,58,5,19,25,107,normal
20:15,15,Sunday,93,22,18,10,143,normal
20:30,15,Sunday,59,23,10,35,127,high
20:45,15,Sunday,57,20,10,20,107,normal
21:00,15,Sunday,96,9,18,25,148,high
21:15,15,Sunday,104,12,16,20,152,normal
21:30,15,Sunday,104,22,17,23,166,high
21:45,15,Sunday,88,8,11,29,136,high
22:00,15,Sunday,20,3,0,16,39,normal
22:15,15,Sunday,17,2,1,30,50,normal
22:30,15,Sunday,17,4,0,23,44,normal
22:45,15,Sunday,15,5,0,21,41,normal
23:00,15,Sunday,10,0,1,31,42,normal
23:15,15,Sunday,11,1,1,19,32,normal
23:30,15,Sunday,12,2,0,29,43,normal
23:45,15,Sunday,11,0,1,11,23,low
0:00,16,Monday,18,4,1,28,51,normal
0:15,16,Monday,13,3,0,26,42,normal
0:30,16,Monday,16,3,0,34,53,normal
0:45,16,Monday,16,4,0,35,55,normal
1:00,16,Monday,20,2,1,33,56,normal
1:15,16,Monday,14,4,1,28,47,normal
1:30,16,Monday,11,4,1,19,35,normal
1:45,16,Monday,19,4,0,17,40,normal
2:00,16,Monday,18,3,1,26,48,normal
2:15,16,Monday,10,1,1,21,33,normal
2:30,16,Monday,20,5,1,40,66,normal
2:45,16,Monday,11,5,0,37,53,normal
3:00,16,Monday,15,4,1,29,49,normal
3:15,16,Monday,16,2,1,27,46,normal
3:30,16,Monday,10,3,1,23,37,normal
3:45,16,Monday,16,5,1,31,53,normal
4:00,16,Monday,20,0,1,30,51,normal
4:15,16,Monday,61,4,5,17,87,normal
4:30,16,Monday,91,8,6,2,107,low
4:45,16,Monday,94,4,5,2,105,low
5:00,16,Monday,117,8,6,16,147,normal
5:15,16,Monday,111,14,10,14,149,normal
5:30,16,Monday,91,2,3,5,101,low
5:45,16,Monday,96,9,1,16,122,normal
6:00,16,Monday,134,15,42,5,196,heavy
6:15,16,Monday,121,35,39,4,199,heavy
6:30,16,Monday,118,40,40,3,201,heavy
6:45,16,Monday,115,17,40,1,173,heavy
7:00,16,Monday,106,22,37,0,165,high
7:15,16,Monday,147,26,40,0,213,heavy
7:30,16,Monday,102,13,31,2,148,high
7:45,16,Monday,102,12,24,3,141,normal
8:00,16,Monday,130,40,31,2,203,heavy
8:15,16,Monday,102,17,33,0,152,high
8:30,16,Monday,105,13,48,5,171,heavy
8:45,16,Monday,129,24,25,0,178,heavy
9:00,16,Monday,117,11,45,0,173,heavy
9:15,16,Monday,74,14,23,21,132,high
9:30,16,Monday,80,14,35,18,147,high
9:45,16,Monday,31,7,34,24,96,normal
10:00,16,Monday,18,15,9,15,57,normal
10:15,16,Monday,15,10,23,20,68,normal
10:30,16,Monday,37,18,8,16,79,normal
10:45,16,Monday,10,7,5,14,36,normal
11:00,16,Monday,54,6,15,23,98,normal
11:15,16,Monday,34,7,5,24,70,normal
11:30,16,Monday,50,7,8,21,86,normal
11:45,16,Monday,44,9,10,24,87,normal
12:00,16,Monday,63,8,15,24,110,normal
12:15,16,Monday,56,6,6,29,97,normal
12:30,16,Monday,69,5,13,27,114,high
12:45,16,Monday,39,5,3,30,77,normal
13:00,16,Monday,61,10,14,24,109,normal
13:15,16,Monday,61,30,5,20,116,normal
13:30,16,Monday,20,17,9,5,51,low
13:45,16,Monday,70,22,38,7,137,high
14:00,16,Monday,25,30,31,9,95,normal
14:15,16,Monday,23,13,12,6,54,low
14:30,16,Monday,105,30,24,8,167,normal
14:45,16,Monday,107,10,6,6,129,normal
15:00,16,Monday,40,20,36,7,103,normal
15:15,16,Monday,74,18,37,11,140,high
15:30,16,Monday,62,15,8,11,96,low
15:45,16,Monday,81,20,14,12,127,normal
16:00,16,Monday,111,32,43,5,191,heavy
16:15,16,Monday,145,12,41,6,204,heavy
16:30,16,Monday,139,11,20,7,177,heavy
16:45,16,Monday,129,40,31,10,210,heavy
17:00,16,Monday,128,22,28,8,186,heavy
17:15,16,Monday,103,17,23,8,151,normal
17:30,16,Monday,127,32,29,7,195,heavy
17:45,16,Monday,120,35,44,8,207,heavy
18:00,16,Monday,106,11,41,7,165,high
18:15,16,Monday,114,40,31,5,190,heavy
18:30,16,Monday,101,13,20,7,141,normal
18:45,16,Monday,110,25,19,34,188,heavy
19:00,16,Monday,108,6,17,23,154,high
19:15,16,Monday,104,12,10,10,136,normal
19:30,16,Monday,102,22,17,23,164,high
19:45,16,Monday,77,19,16,8,120,normal
20:00,16,Monday,70,16,19,33,138,high
20:15,16,Monday,75,9,13,28,125,high
20:30,16,Monday,95,9,16,29,149,high
20:45,16,Monday,77,17,17,22,133,high
21:00,16,Monday,73,16,14,34,137,high
21:15,16,Monday,59,7,18,12,96,normal
21:30,16,Monday,54,20,10,9,93,low
21:45,16,Monday,90,6,18,32,146,high
22:00,16,Monday,15,5,1,32,53,normal
22:15,16,Monday,12,1,0,11,24,low
22:30,16,Monday,17,2,0,28,47,normal
22:45,16,Monday,13,5,1,12,31,low
23:00,16,Monday,15,5,0,21,41,normal
23:15,16,Monday,18,4,0,11,33,low
23:30,16,Monday,12,4,0,21,37,normal
23:45,16,Monday,10,4,1,12,27,low
0:00,17,Tuesday,15,2,0,25,42,normal
0:15,17,Tuesday,11,0,0,24,35,normal
0:30,17,Tuesday,15,2,1,15,33,normal
0:45,17,Tuesday,20,3,1,29,53,normal
1:00,17,Tuesday,17,2,0,24,43,normal
1:15,17,Tuesday,19,5,1,26,51,normal
1:30,17,Tuesday,20,3,1,32,56,normal
1:45,17,Tuesday,15,3,0,19,37,normal
2:00,17,Tuesday,13,5,0,17,35,normal
2:15,17,Tuesday,12,5,1,19,37,normal
2:30,17,Tuesday,10,2,0,27,39,normal
2:45,17,Tuesday,20,4,1,23,48,normal
3:00,17,Tuesday,14,0,0,16,30,normal
3:15,17,Tuesday,12,4,1,28,45,normal
3:30,17,Tuesday,19,2,0,20,41,normal
3:45,17,Tuesday,20,2,1,19,42,normal
4:00,17,Tuesday,16,0,0,36,52,normal
4:15,17,Tuesday,62,20,4,18,104,normal
4:30,17,Tuesday,50,13,2,14,79,normal
4:45,17,Tuesday,101,3,6,6,116,normal
5:00,17,Tuesday,94,15,2,9,120,normal
5:15,17,Tuesday,68,10,8,1,87,low
5:30,17,Tuesday,95,3,8,20,126,normal
5:45,17,Tuesday,113,7,10,16,146,normal
6:00,17,Tuesday,106,13,39,1,159,high
6:15,17,Tuesday,105,32,47,4,188,heavy
6:30,17,Tuesday,150,19,34,4,207,heavy
6:45,17,Tuesday,137,38,39,2,216,heavy
7:00,17,Tuesday,113,11,32,1,157,high
7:15,17,Tuesday,117,30,26,5,178,heavy
7:30,17,Tuesday,130,10,37,1,178,heavy
7:45,17,Tuesday,150,32,31,1,214,heavy
8:00,17,Tuesday,146,10,30,3,189,heavy
8:15,17,Tuesday,123,24,46,2,195,heavy
8:30,17,Tuesday,110,24,26,4,164,high
8:45,17,Tuesday,111,33,31,2,177,heavy
9:00,17,Tuesday,132,18,32,2,184,heavy
9:15,17,Tuesday,66,16,22,13,117,normal
9:30,17,Tuesday,45,24,5,23,97,normal
9:45,17,Tuesday,92,19,15,7,133,normal
10:00,17,Tuesday,78,22,16,25,141,high
10:15,17,Tuesday,90,2,15,18,125,normal
10:30,17,Tuesday,23,2,37,9,71,normal
10:45,17,Tuesday,17,5,6,20,48,normal
11:00,17,Tuesday,41,5,4,24,74,normal
11:15,17,Tuesday,32,5,15,26,78,normal
11:30,17,Tuesday,65,7,7,22,101,normal
11:45,17,Tuesday,22,6,3,25,56,normal
12:00,17,Tuesday,54,7,4,28,93,normal
12:15,17,Tuesday,38,5,8,28,79,normal
12:30,17,Tuesday,59,7,15,23,104,normal
12:45,17,Tuesday,34,8,10,23,75,normal
13:00,17,Tuesday,28,6,3,27,64,normal
13:15,17,Tuesday,7,16,11,14,48,normal
13:30,17,Tuesday,8,12,22,8,50,normal
13:45,17,Tuesday,42,25,38,18,123,high
14:00,17,Tuesday,82,13,28,5,128,high
14:15,17,Tuesday,14,24,26,9,73,normal
14:30,17,Tuesday,39,25,33,9,106,normal
14:45,17,Tuesday,47,14,29,6,96,normal
15:00,17,Tuesday,120,20,21,18,179,heavy
15:15,17,Tuesday,114,11,39,10,174,heavy
15:30,17,Tuesday,99,24,30,10,163,high
15:45,17,Tuesday,78,18,30,8,134,high
16:00,17,Tuesday,144,40,29,10,223,normal
16:15,17,Tuesday,107,28,38,9,182,heavy
16:30,17,Tuesday,123,28,24,10,185,heavy
16:45,17,Tuesday,126,15,28,6,175,heavy
17:00,17,Tuesday,147,28,23,5,203,heavy
17:15,17,Tuesday,100,21,33,7,161,high
17:30,17,Tuesday,113,12,22,6,153,normal
17:45,17,Tuesday,130,34,30,6,200,heavy
18:00,17,Tuesday,118,40,29,10,197,heavy
18:15,17,Tuesday,113,38,44,9,204,heavy
18:30,17,Tuesday,117,29,29,9,184,heavy
18:45,17,Tuesday,106,12,20,32,170,heavy
19:00,17,Tuesday,96,11,15,14,136,normal
19:15,17,Tuesday,58,11,14,24,107,normal
19:30,17,Tuesday,76,22,10,9,117,normal
19:45,17,Tuesday,66,6,12,33,117,high
20:00,17,Tuesday,61,23,13,18,115,normal
20:15,17,Tuesday,93,6,15,17,131,normal
20:30,17,Tuesday,51,11,16,26,104,normal
20:45,17,Tuesday,86,6,12,9,113,normal
21:00,17,Tuesday,77,15,12,29,133,high
21:15,17,Tuesday,84,15,16,8,123,normal
21:30,17,Tuesday,103,12,15,10,140,normal
21:45,17,Tuesday,60,9,11,27,107,normal
22:00,17,Tuesday,14,1,1,22,38,normal
22:15,17,Tuesday,14,2,0,35,51,normal
22:30,17,Tuesday,13,1,1,31,46,normal
22:45,17,Tuesday,19,0,1,22,42,normal
23:00,17,Tuesday,13,4,0,28,45,normal
23:15,17,Tuesday,13,1,0,26,40,normal
23:30,17,Tuesday,12,0,1,34,47,normal
23:45,17,Tuesday,20,1,1,38,60,normal
0:00,18,Wednesday,12,3,0,38,53,normal
0:15,18,Wednesday,12,1,0,40,53,normal
0:30,18,Wednesday,20,5,0,10,35,low
0:45,18,Wednesday,12,4,1,27,44,normal
1:00,18,Wednesday,15,5,0,21,41,normal
1:15,18,Wednesday,19,2,0,30,51,normal
1:30,18,Wednesday,11,0,1,40,52,normal
1:45,18,Wednesday,15,3,0,35,53,normal
2:00,18,Wednesday,15,0,1,37,53,normal
2:15,18,Wednesday,16,2,0,37,55,normal
2:30,18,Wednesday,10,0,1,24,35,normal
2:45,18,Wednesday,12,0,1,31,44,normal
3:00,18,Wednesday,15,1,1,36,53,normal
3:15,18,Wednesday,14,5,0,17,36,normal
3:30,18,Wednesday,17,3,1,38,59,normal
3:45,18,Wednesday,19,0,0,18,37,normal
4:00,18,Wednesday,18,5,1,30,54,normal
4:15,18,Wednesday,119,12,6,4,141,normal
4:30,18,Wednesday,74,28,1,13,116,normal
4:45,18,Wednesday,101,26,10,0,137,normal
5:00,18,Wednesday,99,4,7,19,129,normal
5:15,18,Wednesday,99,18,7,5,129,normal
5:30,18,Wednesday,102,24,2,8,136,normal
5:45,18,Wednesday,50,4,6,13,73,normal
6:00,18,Wednesday,128,11,46,4,189,heavy
6:15,18,Wednesday,129,39,43,0,211,heavy
6:30,18,Wednesday,129,27,38,0,194,heavy
6:45,18,Wednesday,113,24,22,2,161,normal
7:00,18,Wednesday,141,15,21,5,182,heavy
7:15,18,Wednesday,120,22,29,1,172,heavy
7:30,18,Wednesday,141,24,47,4,216,heavy
7:45,18,Wednesday,149,24,33,1,207,heavy
8:00,18,Wednesday,140,40,36,1,217,heavy
8:15,18,Wednesday,140,20,36,0,196,heavy
8:30,18,Wednesday,107,13,31,4,155,high
8:45,18,Wednesday,141,15,32,4,192,heavy
9:00,18,Wednesday,120,27,38,4,189,heavy
9:15,18,Wednesday,70,14,21,5,110,normal
9:30,18,Wednesday,55,24,16,21,116,high
9:45,18,Wednesday,52,18,22,16,108,normal
10:00,18,Wednesday,65,4,19,21,109,normal
10:15,18,Wednesday,54,10,30,28,122,high
10:30,18,Wednesday,37,3,32,18,90,normal
10:45,18,Wednesday,23,3,37,18,81,normal
11:00,18,Wednesday,43,7,7,29,86,normal
11:15,18,Wednesday,22,6,13,24,65,normal
11:30,18,Wednesday,21,10,6,30,67,normal
11:45,18,Wednesday,48,8,11,22,89,normal
12:00,18,Wednesday,35,5,12,20,72,normal
12:15,18,Wednesday,69,5,13,22,109,normal
12:30,18,Wednesday,22,9,10,21,62,normal
12:45,18,Wednesday,46,5,9,23,83,normal
13:00,18,Wednesday,49,5,11,21,86,normal
13:15,18,Wednesday,29,18,29,20,96,normal
13:30,18,Wednesday,96,23,31,14,164,high
13:45,18,Wednesday,100,27,23,16,166,normal
14:00,18,Wednesday,96,22,36,5,159,high
14:15,18,Wednesday,27,26,25,15,93,normal
14:30,18,Wednesday,114,21,32,5,172,heavy
14:45,18,Wednesday,74,27,34,10,145,high
15:00,18,Wednesday,14,16,9,14,53,normal
15:15,18,Wednesday,84,30,26,10,150,high
15:30,18,Wednesday,96,19,14,18,147,normal
15:45,18,Wednesday,40,15,28,5,88,normal
16:00,18,Wednesday,110,15,46,5,176,heavy
16:15,18,Wednesday,138,39,31,7,215,heavy
16:30,18,Wednesday,118,32,32,10,192,heavy
16:45,18,Wednesday,142,34,38,9,223,normal
17:00,18,Wednesday,113,13,36,5,167,normal
17:15,18,Wednesday,104,29,32,7,172,heavy
17:30,18,Wednesday,134,39,21,9,203,heavy
17:45,18,Wednesday,107,15,48,5,175,heavy
18:00,18,Wednesday,139,25,43,7,214,heavy
18:15,18,Wednesday,128,20,20,6,174,heavy
18:30,18,Wednesday,101,13,47,10,171,heavy
18:45,18,Wednesday,105,17,13,23,158,high
19:00,18,Wednesday,103,14,13,9,139,normal
19:15,18,Wednesday,51,23,15,13,102,normal
19:30,18,Wednesday,84,10,16,20,130,normal
19:45,18,Wednesday,97,25,19,24,165,high
20:00,18,Wednesday,98,8,10,19,135,normal
20:15,18,Wednesday,94,13,19,25,151,high
20:30,18,Wednesday,105,25,11,35,176,heavy
20:45,18,Wednesday,74,9,13,6,102,low
21:00,18,Wednesday,57,18,13,28,116,high
21:15,18,Wednesday,57,14,11,33,115,high
21:30,18,Wednesday,84,23,19,15,141,normal
21:45,18,Wednesday,105,14,16,33,168,heavy
22:00,18,Wednesday,10,4,1,38,53,normal
22:15,18,Wednesday,15,1,1,29,46,normal
22:30,18,Wednesday,14,1,1,25,41,normal
22:45,18,Wednesday,20,2,0,37,59,normal
23:00,18,Wednesday,20,1,0,27,48,normal
23:15,18,Wednesday,13,1,1,18,33,normal
23:30,18,Wednesday,19,0,0,35,54,normal
23:45,18,Wednesday,14,1,1,27,43,normal
0:00,19,Thursday,13,5,0,12,30,low
0:15,19,Thursday,18,5,0,12,35,low
0:30,19,Thursday,10,3,1,32,46,normal
0:45,19,Thursday,14,2,0,15,31,normal
1:00,19,Thursday,16,3,0,15,34,normal
1:15,19,Thursday,14,2,0,25,41,normal
1:30,19,Thursday,17,5,0,18,40,normal
1:45,19,Thursday,13,1,0,28,42,normal
2:00,19,Thursday,19,0,1,20,40,normal
2:15,19,Thursday,15,4,0,40,59,normal
2:30,19,Thursday,14,3,1,26,44,normal
2:45,19,Thursday,15,4,0,14,33,normal
3:00,19,Thursday,12,3,1,13,29,normal
3:15,19,Thursday,12,4,0,31,47,normal
3:30,19,Thursday,17,4,1,20,42,normal
3:45,19,Thursday,12,0,1,13,26,normal
4:00,19,Thursday,18,2,0,16,36,normal
4:15,19,Thursday,115,16,10,13,154,normal
4:30,19,Thursday,117,5,10,15,147,normal
4:45,19,Thursday,92,26,8,7,133,normal
5:00,19,Thursday,88,3,6,4,101,low
5:15,19,Thursday,109,11,4,3,127,normal
5:30,19,Thursday,81,4,0,20,105,normal
5:45,19,Thursday,118,2,5,19,144,normal
6:00,19,Thursday,107,26,31,2,166,high
6:15,19,Thursday,103,11,35,5,154,high
6:30,19,Thursday,145,13,33,3,194,heavy
6:45,19,Thursday,143,22,37,4,206,heavy
7:00,19,Thursday,113,38,50,3,204,heavy
7:15,19,Thursday,149,10,47,3,209,heavy
7:30,19,Thursday,132,33,35,2,202,heavy
7:45,19,Thursday,119,40,41,2,202,heavy
8:00,19,Thursday,133,31,27,2,193,heavy
8:15,19,Thursday,140,20,44,4,208,heavy
8:30,19,Thursday,140,34,31,1,206,heavy
8:45,19,Thursday,128,37,50,2,217,heavy
9:00,19,Thursday,132,11,24,3,170,heavy
9:15,19,Thursday,23,8,40,27,98,normal
9:30,19,Thursday,75,2,18,29,124,high
9:45,19,Thursday,99,14,33,14,160,high
10:00,19,Thursday,10,1,13,7,31,low
10:15,19,Thursday,74,21,29,26,150,high
10:30,19,Thursday,29,15,25,5,74,normal
10:45,19,Thursday,50,17,38,24,129,high
11:00,19,Thursday,64,9,14,20,107,normal
11:15,19,Thursday,49,5,10,21,85,normal
11:30,19,Thursday,39,7,10,30,86,normal
11:45,19,Thursday,68,5,5,24,102,normal
12:00,19,Thursday,67,7,8,22,104,normal
12:15,19,Thursday,47,8,3,25,83,normal
12:30,19,Thursday,66,9,7,24,106,normal
12:45,19,Thursday,46,8,3,22,79,normal
13:00,19,Thursday,54,6,12,21,93,normal
13:15,19,Thursday,18,16,32,18,84,normal
13:30,19,Thursday,24,20,7,9,60,low
13:45,19,Thursday,113,17,16,20,166,normal
14:00,19,Thursday,52,13,15,10,90,low
14:15,19,Thursday,58,26,25,18,127,normal
14:30,19,Thursday,44,19,22,6,91,normal
14:45,19,Thursday,8,26,34,9,77,normal
15:00,19,Thursday,31,10,27,8,76,normal
15:15,19,Thursday,115,24,16,5,160,normal
15:30,19,Thursday,56,29,16,16,117,normal
15:45,19,Thursday,7,12,33,12,64,normal
16:00,19,Thursday,133,10,46,10,199,heavy
16:15,19,Thursday,104,31,37,6,178,heavy
16:30,19,Thursday,100,38,36,9,183,heavy
16:45,19,Thursday,127,25,37,5,194,heavy
17:00,19,Thursday,118,32,48,6,204,heavy
17:15,19,Thursday,147,19,31,8,205,heavy
17:30,19,Thursday,123,36,34,5,198,heavy
17:45,19,Thursday,111,24,25,5,165,normal
18:00,19,Thursday,121,16,42,8,187,heavy
18:15,19,Thursday,119,38,47,7,211,heavy
18:30,19,Thursday,132,30,41,6,209,heavy
18:45,19,Thursday,52,6,12,18,88,normal
19:00,19,Thursday,97,21,10,8,136,normal
19:15,19,Thursday,50,16,20,31,117,high
19:30,19,Thursday,94,25,19,8,146,normal
19:45,19,Thursday,66,11,18,34,129,high
20:00,19,Thursday,105,16,15,6,142,normal
20:15,19,Thursday,56,23,10,18,107,normal
20:30,19,Thursday,105,19,10,25,159,high
20:45,19,Thursday,60,18,11,16,105,normal
21:00,19,Thursday,88,10,14,11,123,normal
21:15,19,Thursday,110,6,14,23,153,high
21:30,19,Thursday,78,20,11,35,144,high
21:45,19,Thursday,105,14,10,7,136,normal
22:00,19,Thursday,18,1,0,10,29,low
22:15,19,Thursday,18,1,0,27,46,normal
22:30,19,Thursday,12,4,1,18,35,normal
22:45,19,Thursday,15,4,1,32,52,normal
23:00,19,Thursday,13,4,0,32,49,normal
23:15,19,Thursday,14,4,0,15,33,normal
23:30,19,Thursday,15,4,0,17,36,normal
23:45,19,Thursday,14,0,1,21,36,normal
0:00,20,Friday,17,5,0,37,59,normal
0:15,20,Friday,14,4,1,12,31,low
0:30,20,Friday,16,2,0,15,33,normal
0:45,20,Friday,13,4,1,14,32,normal
1:00,20,Friday,12,4,0,29,45,normal
1:15,20,Friday,19,4,1,30,54,normal
1:30,20,Friday,18,4,0,18,40,normal
1:45,20,Friday,18,1,1,12,32,low
2:00,20,Friday,20,4,1,21,46,normal
2:15,20,Friday,10,2,1,20,33,normal
2:30,20,Friday,18,5,1,23,47,normal
2:45,20,Friday,16,5,1,30,52,normal
3:00,20,Friday,12,3,0,40,55,normal
3:15,20,Friday,12,2,0,40,54,normal
3:30,20,Friday,16,0,1,37,54,normal
3:45,20,Friday,15,4,1,16,36,normal
4:00,20,Friday,13,0,0,38,51,normal
4:15,20,Friday,61,5,3,14,83,normal
4:30,20,Friday,27,15,6,10,58,low
4:45,20,Friday,74,11,5,15,105,normal
5:00,20,Friday,70,6,7,14,97,normal
5:15,20,Friday,33,6,0,11,50,low
5:30,20,Friday,29,12,1,13,55,normal
5:45,20,Friday,69,5,7,10,91,low
6:00,20,Friday,41,16,7,15,79,normal
6:15,20,Friday,35,11,5,11,62,low
6:30,20,Friday,25,9,6,14,54,normal
6:45,20,Friday,65,15,1,11,92,low
7:00,20,Friday,66,6,3,14,89,normal
7:15,20,Friday,27,6,5,15,53,normal
7:30,20,Friday,75,6,1,10,92,low
7:45,20,Friday,54,11,4,12,81,low
8:00,20,Friday,54,18,3,12,87,low
8:15,20,Friday,69,8,0,14,91,normal
8:30,20,Friday,52,19,6,10,87,low
8:45,20,Friday,66,8,0,12,86,low
9:00,20,Friday,54,11,0,13,78,normal
9:15,20,Friday,151,48,15,3,217,heavy
9:30,20,Friday,170,62,18,2,252,heavy
9:45,20,Friday,134,59,11,3,207,heavy
10:00,20,Friday,166,63,22,1,252,heavy
10:15,20,Friday,173,64,10,2,249,heavy
10:30,20,Friday,176,45,22,2,245,heavy
10:45,20,Friday,162,59,27,1,249,heavy
11:00,20,Friday,171,46,15,3,235,heavy
11:15,20,Friday,158,44,26,2,230,heavy
11:30,20,Friday,151,64,16,0,231,heavy
11:45,20,Friday,162,65,14,3,244,heavy
12:00,20,Friday,179,44,23,1,247,heavy
12:15,20,Friday,175,59,11,3,248,heavy
12:30,20,Friday,173,63,13,2,251,heavy
12:45,20,Friday,144,66,11,3,224,heavy
13:00,20,Friday,132,68,22,4,226,heavy
13:15,20,Friday,161,50,10,0,221,heavy
13:30,20,Friday,151,56,29,1,237,heavy
13:45,20,Friday,168,59,24,1,252,heavy
14:00,20,Friday,144,65,20,3,232,heavy
14:15,20,Friday,179,63,12,2,256,heavy
14:30,20,Friday,161,56,12,4,233,heavy
14:45,20,Friday,134,67,12,1,214,heavy
15:00,20,Friday,140,70,23,4,237,heavy
15:15,20,Friday,66,29,24,1,120,normal
15:30,20,Friday,60,27,17,2,106,normal
15:45,20,Friday,89,27,10,2,128,normal
16:00,20,Friday,81,29,5,0,115,normal
16:15,20,Friday,78,22,12,1,113,normal
16:30,20,Friday,71,24,18,2,115,normal
16:45,20,Friday,50,26,9,1,86,low
17:00,20,Friday,55,28,5,0,88,low
17:15,20,Friday,61,20,25,1,107,normal
17:30,20,Friday,76,22,14,2,114,normal
17:45,20,Friday,50,20,23,1,94,normal
18:00,20,Friday,89,26,0,2,117,normal
18:15,20,Friday,62,20,17,0,99,normal
18:30,20,Friday,83,20,23,2,128,normal
18:45,20,Friday,65,20,2,0,87,low
19:00,20,Friday,60,21,2,1,84,low
19:15,20,Friday,36,8,3,9,56,low
19:30,20,Friday,39,5,4,11,59,low
19:45,20,Friday,26,8,3,0,37,low
20:00,20,Friday,23,4,0,5,32,low
20:15,20,Friday,50,2,0,4,56,low
20:30,20,Friday,30,2,3,1,36,low
20:45,20,Friday,48,10,4,2,64,low
21:00,20,Friday,39,6,6,1,52,low
21:15,20,Friday,47,10,3,9,69,low
21:30,20,Friday,26,3,5,3,37,low
21:45,20,Friday,25,6,3,9,43,low
22:00,20,Friday,19,1,0,11,31,low
22:15,20,Friday,16,5,0,26,47,normal
22:30,20,Friday,15,2,1,39,57,normal
22:45,20,Friday,14,5,0,11,30,low
23:00,20,Friday,12,2,0,20,34,normal
23:15,20,Friday,11,2,0,35,48,normal
23:30,20,Friday,18,5,1,11,35,low
23:45,20,Friday,17,2,0,20,39,normal
0:00,21,Sunday,19,5,1,30,55,normal
0:15,21,Sunday,17,4,1,24,46,normal
0:30,21,Sunday,16,3,0,14,33,normal
0:45,21,Sunday,16,3,1,23,43,normal
1:00,21,Sunday,20,0,1,17,38,normal
1:15,21,Sunday,20,0,0,37,57,normal
1:30,21,Sunday,18,0,1,30,49,normal
1:45,21,Sunday,19,1,0,14,34,normal
2:00,21,Sunday,18,5,0,29,52,normal
2:15,21,Sunday,11,1,0,22,34,normal
2:30,21,Sunday,20,3,0,24,47,normal
2:45,21,Sunday,12,2,1,10,25,low
3:00,21,Sunday,19,5,1,31,56,normal
3:15,21,Sunday,10,0,0,32,42,normal
3:30,21,Sunday,14,1,1,12,28,low
3:45,21,Sunday,14,2,1,24,41,normal
4:00,21,Sunday,10,3,0,32,45,normal
4:15,21,Sunday,97,23,6,17,143,normal
4:30,21,Sunday,104,22,7,11,144,normal
4:45,21,Sunday,100,15,8,20,143,normal
5:00,21,Sunday,87,7,7,4,105,low
5:15,21,Sunday,77,27,8,10,122,normal
5:30,21,Sunday,51,7,4,5,67,low
5:45,21,Sunday,79,1,10,6,96,low
6:00,21,Sunday,100,40,29,5,174,heavy
6:15,21,Sunday,112,13,39,0,164,high
6:30,21,Sunday,120,16,34,2,172,heavy
6:45,21,Sunday,123,14,26,3,166,high
7:00,21,Sunday,142,27,27,4,200,heavy
7:15,21,Sunday,139,38,49,2,228,heavy
7:30,21,Sunday,134,24,21,2,181,heavy
7:45,21,Sunday,102,13,31,0,146,high
8:00,21,Sunday,102,16,43,4,165,high
8:15,21,Sunday,106,16,32,1,155,high
8:30,21,Sunday,117,19,42,3,181,heavy
8:45,21,Sunday,139,36,40,3,218,heavy
9:00,21,Sunday,121,13,25,2,161,normal
9:15,21,Sunday,65,19,16,11,111,normal
9:30,21,Sunday,12,25,39,28,104,normal
9:45,21,Sunday,98,21,10,5,134,normal
10:00,21,Sunday,58,9,25,13,105,normal
10:15,21,Sunday,81,10,39,29,159,high
10:30,21,Sunday,67,20,33,29,149,high
10:45,21,Sunday,68,22,25,16,131,normal
11:00,21,Sunday,47,10,6,22,85,normal
11:15,21,Sunday,45,7,10,27,89,normal
11:30,21,Sunday,54,5,11,24,94,normal
11:45,21,Sunday,61,7,15,28,111,normal
12:00,21,Sunday,56,5,4,29,94,normal
12:15,21,Sunday,23,5,4,27,59,normal
12:30,21,Sunday,31,6,8,23,68,normal
12:45,21,Sunday,27,7,14,28,76,normal
13:00,21,Sunday,30,7,3,30,70,normal
13:15,21,Sunday,114,21,5,14,154,normal
13:30,21,Sunday,46,24,35,16,121,high
13:45,21,Sunday,68,29,29,20,146,high
14:00,21,Sunday,45,16,15,5,81,low
14:15,21,Sunday,86,13,11,20,130,normal
14:30,21,Sunday,44,11,19,15,89,normal
14:45,21,Sunday,45,17,13,20,95,normal
15:00,21,Sunday,106,17,7,12,142,normal
15:15,21,Sunday,44,16,9,13,82,normal
15:30,21,Sunday,77,23,13,9,122,normal
15:45,21,Sunday,53,17,26,8,104,normal
16:00,21,Sunday,138,18,20,8,184,heavy
16:15,21,Sunday,142,24,39,9,214,heavy
16:30,21,Sunday,114,25,21,7,167,normal
16:45,21,Sunday,116,35,42,6,199,heavy
17:00,21,Sunday,149,22,37,8,216,heavy
17:15,21,Sunday,100,12,39,7,158,high
17:30,21,Sunday,101,23,45,5,174,heavy
17:45,21,Sunday,122,40,48,10,220,heavy
18:00,21,Sunday,112,34,39,9,194,heavy
18:15,21,Sunday,112,12,41,5,170,heavy
18:30,21,Sunday,116,22,23,7,168,heavy
18:45,21,Sunday,90,13,15,33,151,high
19:00,21,Sunday,85,14,14,13,126,normal
19:15,21,Sunday,59,25,13,27,124,high
19:30,21,Sunday,108,5,15,22,150,high
19:45,21,Sunday,75,8,16,25,124,high
20:00,21,Sunday,96,15,12,27,150,high
20:15,21,Sunday,61,17,10,8,96,low
20:30,21,Sunday,84,25,20,30,159,high
20:45,21,Sunday,55,9,12,19,95,normal
21:00,21,Sunday,65,16,12,32,125,high
21:15,21,Sunday,87,16,10,16,129,normal
21:30,21,Sunday,75,5,12,21,113,high
21:45,21,Sunday,82,16,14,34,146,high
22:00,21,Sunday,11,3,0,34,48,normal
22:15,21,Sunday,15,5,0,14,34,normal
22:30,21,Sunday,18,5,1,13,37,normal
22:45,21,Sunday,19,2,1,34,56,normal
23:00,21,Sunday,20,4,1,26,51,normal
23:15,21,Sunday,14,4,0,10,28,low
23:30,21,Sunday,11,1,1,36,49,normal
23:45,21,Sunday,10,2,1,15,28,normal
0:00,22,Saturday,10,3,0,33,46,normal
0:15,22,Saturday,14,3,0,23,40,normal
0:30,22,Saturday,11,5,1,11,28,low
0:45,22,Saturday,10,1,1,34,46,normal
1:00,22,Saturday,20,4,1,17,42,normal
1:15,22,Saturday,17,5,0,24,46,normal
1:30,22,Saturday,12,2,1,18,33,normal
1:45,22,Saturday,15,0,1,16,32,normal
2:00,22,Saturday,19,5,0,15,39,normal
2:15,22,Saturday,11,3,1,39,54,normal
2:30,22,Saturday,14,5,0,10,29,low
2:45,22,Saturday,20,0,1,33,54,normal
3:00,22,Saturday,13,1,1,33,48,normal
3:15,22,Saturday,18,2,1,12,33,low
3:30,22,Saturday,19,2,1,23,45,normal
3:45,22,Saturday,10,4,0,36,50,normal
4:00,22,Saturday,13,4,0,17,34,normal
4:15,22,Saturday,86,28,2,18,134,normal
4:30,22,Saturday,59,29,9,14,111,normal
4:45,22,Saturday,102,20,9,13,144,normal
5:00,22,Saturday,114,28,8,16,166,normal
5:15,22,Saturday,87,23,5,0,115,normal
5:30,22,Saturday,88,5,8,13,114,normal
5:45,22,Saturday,83,6,4,9,102,low
6:00,22,Saturday,150,19,24,3,196,heavy
6:15,22,Saturday,148,35,46,1,230,heavy
6:30,22,Saturday,146,23,23,4,196,heavy
6:45,22,Saturday,140,21,39,3,203,heavy
7:00,22,Saturday,149,36,35,1,221,heavy
7:15,22,Saturday,125,34,42,0,201,heavy
7:30,22,Saturday,147,34,20,5,206,heavy
7:45,22,Saturday,128,33,21,4,186,heavy
8:00,22,Saturday,111,38,50,5,204,heavy
8:15,22,Saturday,144,20,32,4,200,heavy
8:30,22,Saturday,121,14,23,1,159,normal
8:45,22,Saturday,136,36,40,4,216,heavy
9:00,22,Saturday,114,21,23,1,159,normal
9:15,22,Saturday,75,17,37,29,158,high
9:30,22,Saturday,34,5,27,22,88,normal
9:45,22,Saturday,45,6,7,15,73,normal
10:00,22,Saturday,65,10,6,27,108,normal
10:15,22,Saturday,67,25,20,18,130,normal
10:30,22,Saturday,50,25,25,28,128,high
10:45,22,Saturday,37,19,38,12,106,normal
11:00,22,Saturday,36,8,3,29,76,normal
11:15,22,Saturday,63,5,8,23,99,normal
11:30,22,Saturday,67,5,7,22,101,normal
11:45,22,Saturday,36,9,14,22,81,normal
12:00,22,Saturday,57,8,10,22,97,normal
12:15,22,Saturday,65,7,14,25,111,normal
12:30,22,Saturday,54,10,3,29,96,normal
12:45,22,Saturday,41,5,4,25,75,normal
13:00,22,Saturday,43,9,3,25,80,normal
13:15,22,Saturday,9,27,32,17,85,normal
13:30,22,Saturday,101,28,18,20,167,normal
13:45,22,Saturday,99,16,16,18,149,normal
14:00,22,Saturday,20,27,32,12,91,normal
14:15,22,Saturday,96,16,39,17,168,heavy
14:30,22,Saturday,62,28,18,20,128,normal
14:45,22,Saturday,58,27,17,5,107,normal
15:00,22,Saturday,60,18,28,12,118,high
15:15,22,Saturday,81,26,13,17,137,normal
15:30,22,Saturday,118,15,27,13,173,heavy
15:45,22,Saturday,53,12,25,20,110,normal
16:00,22,Saturday,132,12,27,9,180,heavy
16:15,22,Saturday,149,14,50,5,218,heavy
16:30,22,Saturday,106,35,41,5,187,heavy
16:45,22,Saturday,150,29,27,7,213,heavy
17:00,22,Saturday,110,30,46,5,191,heavy
17:15,22,Saturday,129,35,34,5,203,heavy
17:30,22,Saturday,133,21,26,5,185,heavy
17:45,22,Saturday,148,34,45,7,234,heavy
18:00,22,Saturday,144,39,43,8,234,heavy
18:15,22,Saturday,126,27,44,8,205,heavy
18:30,22,Saturday,103,34,49,5,191,heavy
18:45,22,Saturday,96,7,13,30,146,high
19:00,22,Saturday,54,17,17,19,107,normal
19:15,22,Saturday,98,16,17,15,146,normal
19:30,22,Saturday,72,6,19,8,105,normal
19:45,22,Saturday,69,23,12,31,135,high
20:00,22,Saturday,85,13,16,24,138,high
20:15,22,Saturday,102,22,12,9,145,normal
20:30,22,Saturday,103,14,20,14,151,normal
20:45,22,Saturday,80,12,10,22,124,high
21:00,22,Saturday,63,18,11,5,97,low
21:15,22,Saturday,84,21,13,9,127,normal
21:30,22,Saturday,72,10,10,29,121,high
21:45,22,Saturday,79,22,17,13,131,normal
22:00,22,Saturday,12,5,0,27,44,normal
22:15,22,Saturday,19,1,1,38,59,normal
22:30,22,Saturday,14,3,0,33,50,normal
22:45,22,Saturday,16,3,1,37,57,normal
23:00,22,Saturday,14,5,0,37,56,normal
23:15,22,Saturday,11,2,1,20,34,normal
23:30,22,Saturday,20,3,0,25,48,normal
23:45,22,Saturday,20,0,1,30,51,normal
0:00,23,Monday,13,2,1,17,33,normal
0:15,23,Monday,20,1,1,19,41,normal
0:30,23,Monday,10,2,1,12,25,low
0:45,23,Monday,14,2,0,25,41,normal
1:00,23,Monday,12,0,1,16,29,normal
1:15,23,Monday,11,5,1,31,48,normal
1:30,23,Monday,13,1,1,16,31,normal
1:45,23,Monday,17,3,0,10,30,low
2:00,23,Monday,11,1,0,22,34,normal
2:15,23,Monday,10,4,1,16,31,normal
2:30,23,Monday,15,3,1,32,51,normal
2:45,23,Monday,10,0,0,22,32,normal
3:00,23,Monday,20,1,1,16,38,normal
3:15,23,Monday,16,1,1,15,33,normal
3:30,23,Monday,14,4,1,32,51,normal
3:45,23,Monday,16,1,1,37,55,normal
4:00,23,Monday,10,2,1,36,49,normal
4:15,23,Monday,96,18,7,2,123,normal
4:30,23,Monday,51,14,0,5,70,low
4:45,23,Monday,63,25,2,8,98,low
5:00,23,Monday,72,7,1,4,84,low
5:15,23,Monday,86,18,6,1,111,low
5:30,23,Monday,105,4,4,20,133,normal
5:45,23,Monday,117,10,10,18,155,normal
6:00,23,Monday,120,36,32,0,188,heavy
6:15,23,Monday,135,20,31,0,186,heavy
6:30,23,Monday,112,40,42,3,197,heavy
6:45,23,Monday,135,13,20,3,171,heavy
7:00,23,Monday,105,35,24,2,166,normal
7:15,23,Monday,150,25,36,0,211,heavy
7:30,23,Monday,108,27,23,2,160,normal
7:45,23,Monday,108,40,45,1,194,heavy
8:00,23,Monday,118,19,21,1,159,normal
8:15,23,Monday,131,18,41,1,191,heavy
8:30,23,Monday,148,31,20,4,203,heavy
8:45,23,Monday,120,26,22,1,169,heavy
9:00,23,Monday,147,12,32,0,191,heavy
9:15,23,Monday,73,9,35,12,129,high
9:30,23,Monday,93,21,22,29,165,high
9:45,23,Monday,66,2,10,28,106,normal
10:00,23,Monday,18,6,6,6,36,low
10:15,23,Monday,78,1,16,30,125,high
10:30,23,Monday,69,15,24,20,128,normal
10:45,23,Monday,82,2,40,17,141,high
11:00,23,Monday,57,9,5,23,94,normal
11:15,23,Monday,25,5,14,26,70,normal
11:30,23,Monday,40,9,15,28,92,normal
11:45,23,Monday,52,6,13,21,92,normal
12:00,23,Monday,45,8,13,29,95,normal
12:15,23,Monday,67,10,7,25,109,normal
12:30,23,Monday,20,8,14,30,72,normal
12:45,23,Monday,44,8,4,29,85,normal
13:00,23,Monday,63,5,8,29,105,normal
13:15,23,Monday,119,15,20,13,167,normal
13:30,23,Monday,103,10,23,7,143,normal
13:45,23,Monday,42,14,15,14,85,normal
14:00,23,Monday,67,20,24,12,123,normal
14:15,23,Monday,56,18,29,17,120,high
14:30,23,Monday,65,16,32,15,128,high
14:45,23,Monday,107,11,26,19,163,high
15:00,23,Monday,11,18,22,10,61,normal
15:15,23,Monday,28,15,27,12,82,normal
15:30,23,Monday,45,17,7,6,75,low
15:45,23,Monday,66,12,27,6,111,normal
16:00,23,Monday,104,40,22,9,175,heavy
16:15,23,Monday,113,21,26,5,165,high
16:30,23,Monday,120,29,37,6,192,heavy
16:45,23,Monday,129,10,39,6,184,heavy
17:00,23,Monday,119,29,40,10,198,heavy
17:15,23,Monday,119,25,32,9,185,heavy
17:30,23,Monday,123,10,30,7,170,heavy
17:45,23,Monday,111,33,28,5,177,heavy
18:00,23,Monday,110,12,47,8,177,heavy
18:15,23,Monday,139,15,43,9,206,heavy
18:30,23,Monday,132,29,25,7,193,heavy
18:45,23,Monday,51,8,18,18,95,normal
19:00,23,Monday,76,5,14,20,115,normal
19:15,23,Monday,53,15,13,23,104,normal
19:30,23,Monday,50,25,19,9,103,normal
19:45,23,Monday,86,24,20,34,164,high
20:00,23,Monday,67,23,14,13,117,normal
20:15,23,Monday,54,9,15,7,85,low
20:30,23,Monday,59,12,16,35,122,high
20:45,23,Monday,109,25,15,5,154,normal
21:00,23,Monday,73,18,10,35,136,high
21:15,23,Monday,65,24,14,19,122,normal
21:30,23,Monday,94,10,11,22,137,high
21:45,23,Monday,106,9,12,31,158,high
22:00,23,Monday,18,3,0,11,32,low
22:15,23,Monday,17,1,1,36,55,normal
22:30,23,Monday,12,0,0,22,34,normal
22:45,23,Monday,11,1,0,19,31,normal
23:00,23,Monday,16,1,0,32,49,normal
23:15,23,Monday,12,3,1,13,29,normal
23:30,23,Monday,14,4,1,27,46,normal
23:45,23,Monday,11,3,1,37,52,normal
0:00,24,Tuesday,17,2,0,18,37,normal
0:15,24,Tuesday,18,4,1,39,62,normal
0:30,24,Tuesday,20,4,0,32,56,normal
0:45,24,Tuesday,15,0,0,28,43,normal
1:00,24,Tuesday,11,4,0,12,27,low
1:15,24,Tuesday,19,5,1,35,60,normal
1:30,24,Tuesday,15,0,1,26,42,normal
1:45,24,Tuesday,11,4,0,31,46,normal
2:00,24,Tuesday,19,2,1,33,55,normal
2:15,24,Tuesday,12,4,1,29,46,normal
2:30,24,Tuesday,15,5,1,16,37,normal
2:45,24,Tuesday,14,4,1,21,40,normal
3:00,24,Tuesday,19,4,1,17,41,normal
3:15,24,Tuesday,10,2,1,12,25,low
3:30,24,Tuesday,10,0,0,11,21,low
3:45,24,Tuesday,20,4,1,33,58,normal
4:00,24,Tuesday,10,1,0,12,23,low
4:15,24,Tuesday,73,12,5,5,95,low
4:30,24,Tuesday,95,15,4,19,133,normal
4:45,24,Tuesday,81,19,3,13,116,normal
5:00,24,Tuesday,119,25,10,9,163,normal
5:15,24,Tuesday,80,10,4,15,109,normal
5:30,24,Tuesday,102,24,3,16,145,normal
5:45,24,Tuesday,68,17,6,10,101,low
6:00,24,Tuesday,109,40,38,0,187,heavy
6:15,24,Tuesday,124,25,31,1,181,heavy
6:30,24,Tuesday,126,22,21,1,170,heavy
6:45,24,Tuesday,120,31,29,5,185,heavy
7:00,24,Tuesday,101,20,47,5,173,heavy
7:15,24,Tuesday,139,40,48,2,229,heavy
7:30,24,Tuesday,116,23,23,4,166,normal
7:45,24,Tuesday,101,14,24,0,139,normal
8:00,24,Tuesday,137,40,21,5,203,heavy
8:15,24,Tuesday,131,26,36,0,193,heavy
8:30,24,Tuesday,114,27,45,4,190,heavy
8:45,24,Tuesday,102,14,46,1,163,high
9:00,24,Tuesday,116,24,32,5,177,heavy
9:15,24,Tuesday,29,10,21,12,72,normal
9:30,24,Tuesday,41,12,15,10,78,low
9:45,24,Tuesday,41,9,7,27,84,normal
10:00,24,Tuesday,90,25,26,10,151,high
10:15,24,Tuesday,64,25,17,20,126,normal
10:30,24,Tuesday,64,10,17,23,114,high
10:45,24,Tuesday,69,17,5,28,119,high
11:00,24,Tuesday,59,9,9,21,98,normal
11:15,24,Tuesday,44,10,12,29,95,normal
11:30,24,Tuesday,43,5,6,26,80,normal
11:45,24,Tuesday,65,7,10,21,103,normal
12:00,24,Tuesday,29,5,12,21,67,normal
12:15,24,Tuesday,24,9,8,20,61,normal
12:30,24,Tuesday,44,6,4,26,80,normal
12:45,24,Tuesday,35,10,12,24,81,normal
13:00,24,Tuesday,43,10,15,21,89,normal
13:15,24,Tuesday,45,17,24,11,97,normal
13:30,24,Tuesday,108,21,37,14,180,heavy
13:45,24,Tuesday,53,19,33,9,114,high
14:00,24,Tuesday,75,23,31,13,142,high
14:15,24,Tuesday,70,18,5,19,112,normal
14:30,24,Tuesday,52,25,15,19,111,normal
14:45,24,Tuesday,9,18,24,9,60,normal
15:00,24,Tuesday,47,21,9,18,95,normal
15:15,24,Tuesday,116,20,17,19,172,heavy
15:30,24,Tuesday,65,14,6,9,94,low
15:45,24,Tuesday,93,12,13,13,131,normal
16:00,24,Tuesday,100,21,45,9,175,heavy
16:15,24,Tuesday,121,24,31,6,182,heavy
16:30,24,Tuesday,110,15,50,5,180,heavy
16:45,24,Tuesday,103,17,28,5,153,high
17:00,24,Tuesday,136,38,20,5,199,heavy
17:15,24,Tuesday,119,22,32,9,182,heavy
17:30,24,Tuesday,132,17,36,5,190,heavy
17:45,24,Tuesday,147,10,41,5,203,heavy
18:00,24,Tuesday,111,12,44,6,173,heavy
18:15,24,Tuesday,102,27,32,5,166,high
18:30,24,Tuesday,137,25,29,7,198,heavy
18:45,24,Tuesday,71,17,15,31,134,high
19:00,24,Tuesday,64,25,11,15,115,normal
19:15,24,Tuesday,70,16,15,29,130,high
19:30,24,Tuesday,91,9,11,32,143,high
19:45,24,Tuesday,95,6,11,35,147,high
20:00,24,Tuesday,76,16,10,31,133,high
20:15,24,Tuesday,87,17,18,7,129,normal
20:30,24,Tuesday,63,22,12,29,126,high
20:45,24,Tuesday,56,17,20,8,101,normal
21:00,24,Tuesday,102,18,19,29,168,heavy
21:15,24,Tuesday,60,23,10,13,106,normal
21:30,24,Tuesday,88,6,18,25,137,high
21:45,24,Tuesday,104,15,10,32,161,high
22:00,24,Tuesday,16,1,1,26,44,normal
22:15,24,Tuesday,12,1,0,12,25,low
22:30,24,Tuesday,16,1,0,29,46,normal
22:45,24,Tuesday,13,5,0,31,49,normal
23:00,24,Tuesday,20,1,1,27,49,normal
23:15,24,Tuesday,18,0,0,29,47,normal
23:30,24,Tuesday,16,3,1,26,46,normal
23:45,24,Tuesday,18,0,0,21,39,normal
0:00,25,Wednesday,11,5,0,24,40,normal
0:15,25,Wednesday,13,1,0,10,24,low
0:30,25,Wednesday,10,1,0,26,37,normal
0:45,25,Wednesday,19,5,1,22,47,normal
1:00,25,Wednesday,20,0,0,10,30,low
1:15,25,Wednesday,16,4,1,39,60,normal
1:30,25,Wednesday,19,1,1,11,32,low
1:45,25,Wednesday,20,4,0,38,62,normal
2:00,25,Wednesday,15,1,1,15,32,normal
2:15,25,Wednesday,10,0,0,33,43,normal
2:30,25,Wednesday,20,5,0,24,49,normal
2:45,25,Wednesday,12,2,1,35,50,normal
3:00,25,Wednesday,10,4,1,37,52,normal
3:15,25,Wednesday,15,4,0,38,57,normal
3:30,25,Wednesday,19,0,1,39,59,normal
3:45,25,Wednesday,16,4,0,35,55,normal
4:00,25,Wednesday,20,3,1,35,59,normal
4:15,25,Wednesday,118,1,0,4,123,normal
4:30,25,Wednesday,89,20,4,17,130,normal
4:45,25,Wednesday,120,18,6,13,157,normal
5:00,25,Wednesday,85,7,3,18,113,normal
5:15,25,Wednesday,99,8,2,14,123,normal
5:30,25,Wednesday,59,25,2,7,93,low
5:45,25,Wednesday,58,25,2,5,90,low
6:00,25,Wednesday,113,40,36,4,193,heavy
6:15,25,Wednesday,113,16,50,2,181,heavy
6:30,25,Wednesday,121,27,50,4,202,heavy
6:45,25,Wednesday,150,17,28,0,195,heavy
7:00,25,Wednesday,136,29,23,0,188,heavy
7:15,25,Wednesday,142,32,27,2,203,heavy
7:30,25,Wednesday,106,32,42,2,182,heavy
7:45,25,Wednesday,103,21,20,0,144,normal
8:00,25,Wednesday,131,19,26,1,177,heavy
8:15,25,Wednesday,133,23,21,3,180,heavy
8:30,25,Wednesday,123,17,50,1,191,heavy
8:45,25,Wednesday,124,21,35,2,182,heavy
9:00,25,Wednesday,136,26,20,4,186,heavy
9:15,25,Wednesday,92,10,39,19,160,high
9:30,25,Wednesday,82,7,13,19,121,normal
9:45,25,Wednesday,42,2,28,27,99,normal
10:00,25,Wednesday,24,17,17,9,67,normal
10:15,25,Wednesday,42,19,17,12,90,normal
10:30,25,Wednesday,100,12,5,23,140,high
10:45,25,Wednesday,11,25,30,22,88,normal
11:00,25,Wednesday,27,7,10,22,66,normal
11:15,25,Wednesday,38,7,11,20,76,normal
11:30,25,Wednesday,49,10,6,27,92,normal
11:45,25,Wednesday,66,9,7,28,110,normal
12:00,25,Wednesday,70,8,3,22,103,normal
12:15,25,Wednesday,58,7,6,27,98,normal
12:30,25,Wednesday,53,9,13,29,104,normal
12:45,25,Wednesday,22,5,6,26,59,normal
13:00,25,Wednesday,40,10,11,28,89,normal
13:15,25,Wednesday,58,13,10,12,93,low
13:30,25,Wednesday,60,25,24,17,126,normal
13:45,25,Wednesday,25,11,24,17,77,normal
14:00,25,Wednesday,22,28,11,18,79,normal
14:15,25,Wednesday,6,11,37,15,69,normal
14:30,25,Wednesday,92,18,34,18,162,high
14:45,25,Wednesday,97,17,38,20,172,heavy
15:00,25,Wednesday,92,18,31,6,147,high
15:15,25,Wednesday,74,12,17,16,119,normal
15:30,25,Wednesday,67,22,7,5,101,low
15:45,25,Wednesday,84,20,25,15,144,normal
16:00,25,Wednesday,144,15,42,8,209,heavy
16:15,25,Wednesday,120,11,47,7,185,heavy
16:30,25,Wednesday,108,10,36,6,160,high
16:45,25,Wednesday,141,13,50,6,210,heavy
17:00,25,Wednesday,121,37,29,8,195,heavy
17:15,25,Wednesday,142,40,22,6,210,heavy
17:30,25,Wednesday,137,23,28,7,195,heavy
17:45,25,Wednesday,117,10,27,8,162,high
18:00,25,Wednesday,100,16,37,7,160,high
18:15,25,Wednesday,148,11,42,8,209,heavy
18:30,25,Wednesday,148,27,39,6,220,heavy
18:45,25,Wednesday,65,18,20,21,124,high
19:00,25,Wednesday,75,9,14,6,104,low
19:15,25,Wednesday,85,15,20,29,149,high
19:30,25,Wednesday,57,21,20,18,116,normal
19:45,25,Wednesday,50,7,13,30,100,normal
20:00,25,Wednesday,87,21,14,34,156,high
20:15,25,Wednesday,64,24,11,6,105,low
20:30,25,Wednesday,76,6,18,14,114,normal
20:45,25,Wednesday,69,11,12,8,100,low
21:00,25,Wednesday,76,9,17,14,116,normal
21:15,25,Wednesday,94,8,15,5,122,normal
21:30,25,Wednesday,104,10,16,33,163,high
21:45,25,Wednesday,98,13,13,33,157,high
22:00,25,Wednesday,13,5,0,18,36,normal
22:15,25,Wednesday,17,1,0,11,29,low
22:30,25,Wednesday,18,2,1,34,55,normal
22:45,25,Wednesday,11,1,0,35,47,normal
23:00,25,Wednesday,17,4,0,11,32,low
23:15,25,Wednesday,17,1,1,23,42,normal
23:30,25,Wednesday,17,2,0,23,42,normal
23:45,25,Wednesday,16,4,1,30,51,normal
0:00,26,Thursday,15,5,1,23,44,normal
0:15,26,Thursday,18,0,0,31,49,normal
0:30,26,Thursday,10,1,0,17,28,normal
0:45,26,Thursday,13,2,0,32,47,normal
1:00,26,Thursday,16,1,0,38,55,normal
1:15,26,Thursday,11,4,0,32,47,normal
1:30,26,Thursday,12,2,0,26,40,normal
1:45,26,Thursday,14,2,1,14,31,normal
2:00,26,Thursday,18,2,0,37,57,normal
2:15,26,Thursday,17,1,1,22,41,normal
2:30,26,Thursday,12,3,0,29,44,normal
2:45,26,Thursday,20,5,0,30,55,normal
3:00,26,Thursday,17,5,1,19,42,normal
3:15,26,Thursday,12,0,1,33,46,normal
3:30,26,Thursday,19,1,0,20,40,normal
3:45,26,Thursday,11,4,1,38,54,normal
4:00,26,Thursday,14,5,0,39,58,normal
4:15,26,Thursday,102,20,4,12,138,normal
4:30,26,Thursday,92,4,6,18,120,normal
4:45,26,Thursday,54,14,10,16,94,normal
5:00,26,Thursday,55,15,1,10,81,low
5:15,26,Thursday,64,27,5,5,101,low
5:30,26,Thursday,52,13,5,15,85,normal
5:45,26,Thursday,73,11,4,3,91,low
6:00,26,Thursday,106,27,45,5,183,heavy
6:15,26,Thursday,145,21,40,5,211,heavy
6:30,26,Thursday,133,19,28,5,185,heavy
6:45,26,Thursday,117,31,49,0,197,heavy
7:00,26,Thursday,146,17,34,0,197,heavy
7:15,26,Thursday,101,35,42,3,181,heavy
7:30,26,Thursday,103,28,32,1,164,high
7:45,26,Thursday,150,10,26,0,186,heavy
8:00,26,Thursday,135,23,48,0,206,heavy
8:15,26,Thursday,104,10,48,2,164,high
8:30,26,Thursday,144,39,50,1,234,heavy
8:45,26,Thursday,132,10,49,0,191,heavy
9:00,26,Thursday,142,19,31,1,193,heavy
9:15,26,Thursday,45,4,30,29,108,normal
9:30,26,Thursday,27,24,10,5,66,low
9:45,26,Thursday,85,3,14,16,118,normal
10:00,26,Thursday,84,11,27,26,148,high
10:15,26,Thursday,90,4,10,20,124,normal
10:30,26,Thursday,13,19,39,12,83,normal
10:45,26,Thursday,11,1,37,9,58,normal
11:00,26,Thursday,57,10,4,27,98,normal
11:15,26,Thursday,52,10,9,23,94,normal
11:30,26,Thursday,38,7,13,21,79,normal
11:45,26,Thursday,35,7,15,24,81,normal
12:00,26,Thursday,60,10,12,21,103,normal
12:15,26,Thursday,70,10,3,30,113,high
12:30,26,Thursday,34,8,6,30,78,normal
12:45,26,Thursday,44,6,4,27,81,normal
13:00,26,Thursday,21,5,4,25,55,normal
13:15,26,Thursday,106,10,11,11,138,normal
13:30,26,Thursday,82,30,32,10,154,high
13:45,26,Thursday,57,12,9,17,95,normal
14:00,26,Thursday,60,18,21,10,109,normal
14:15,26,Thursday,79,17,34,8,138,high
14:30,26,Thursday,78,29,22,13,142,normal
14:45,26,Thursday,69,14,32,18,133,high
15:00,26,Thursday,84,25,5,9,123,normal
15:15,26,Thursday,62,11,28,5,106,normal
15:30,26,Thursday,33,17,22,18,90,normal
15:45,26,Thursday,14,21,23,6,64,normal
16:00,26,Thursday,127,27,40,5,199,heavy
16:15,26,Thursday,136,10,27,7,180,heavy
16:30,26,Thursday,148,14,37,9,208,heavy
16:45,26,Thursday,122,16,28,6,172,heavy
17:00,26,Thursday,132,12,45,9,198,heavy
17:15,26,Thursday,136,29,29,10,204,heavy
17:30,26,Thursday,103,33,48,10,194,heavy
17:45,26,Thursday,132,37,23,10,202,heavy
18:00,26,Thursday,136,39,39,6,220,heavy
18:15,26,Thursday,120,24,36,5,185,heavy
18:30,26,Thursday,126,34,38,9,207,heavy
18:45,26,Thursday,80,22,14,18,134,normal
19:00,26,Thursday,99,9,15,29,152,high
19:15,26,Thursday,81,21,19,7,128,normal
19:30,26,Thursday,87,9,16,26,138,high
19:45,26,Thursday,80,17,13,30,140,high
20:00,26,Thursday,91,18,18,9,136,normal
20:15,26,Thursday,90,19,15,13,137,normal
20:30,26,Thursday,107,19,10,23,159,high
20:45,26,Thursday,98,11,14,27,150,high
21:00,26,Thursday,98,18,20,22,158,high
21:15,26,Thursday,102,5,12,17,136,normal
21:30,26,Thursday,62,13,16,28,119,high
21:45,26,Thursday,101,15,12,35,163,high
22:00,26,Thursday,17,5,1,16,39,normal
22:15,26,Thursday,10,4,1,37,52,normal
22:30,26,Thursday,16,4,0,35,55,normal
22:45,26,Thursday,17,2,0,17,36,normal
23:00,26,Thursday,17,0,0,27,44,normal
23:15,26,Thursday,17,4,1,25,47,normal
23:30,26,Thursday,15,2,0,15,32,normal
23:45,26,Thursday,20,0,1,12,33,low
0:00,27,Friday,16,3,0,28,47,normal
0:15,27,Friday,13,2,1,28,44,normal
0:30,27,Friday,15,5,0,26,46,normal
0:45,27,Friday,15,2,1,16,34,normal
1:00,27,Friday,12,3,0,26,41,normal
1:15,27,Friday,15,5,0,27,47,normal
1:30,27,Friday,20,2,0,17,39,normal
1:45,27,Friday,12,2,0,16,30,normal
2:00,27,Friday,19,1,0,38,58,normal
2:15,27,Friday,16,1,1,32,50,normal
2:30,27,Friday,12,0,0,11,23,low
2:45,27,Friday,16,5,1,29,51,normal
3:00,27,Friday,19,5,1,18,43,normal
3:15,27,Friday,11,0,0,15,26,normal
3:30,27,Friday,15,4,1,17,37,normal
3:45,27,Friday,20,1,0,23,44,normal
4:00,27,Friday,10,4,0,36,50,normal
4:15,27,Friday,39,14,0,15,68,normal
4:30,27,Friday,33,7,3,10,53,low
4:45,27,Friday,77,8,7,15,107,normal
5:00,27,Friday,80,18,6,11,115,normal
5:15,27,Friday,53,11,7,15,86,normal
5:30,27,Friday,73,17,6,13,109,normal
5:45,27,Friday,77,20,4,13,114,normal
6:00,27,Friday,76,14,1,12,103,low
6:15,27,Friday,58,14,0,15,87,normal
6:30,27,Friday,57,18,7,13,95,normal
6:45,27,Friday,80,16,0,10,106,low
7:00,27,Friday,38,7,1,13,59,normal
7:15,27,Friday,53,20,6,12,91,low
7:30,27,Friday,30,9,7,10,56,low
7:45,27,Friday,50,19,4,10,83,low
8:00,27,Friday,31,14,3,14,62,normal
8:15,27,Friday,28,18,5,10,61,low
8:30,27,Friday,31,15,4,12,62,low
8:45,27,Friday,52,19,0,10,81,low
9:00,27,Friday,42,9,2,13,66,normal
9:15,27,Friday,151,55,27,2,235,heavy
9:30,27,Friday,180,69,29,1,279,heavy
9:45,27,Friday,149,41,23,3,216,heavy
10:00,27,Friday,167,60,27,3,257,heavy
10:15,27,Friday,134,45,22,3,204,heavy
10:30,27,Friday,180,62,26,4,272,heavy
10:45,27,Friday,156,54,25,3,238,heavy
11:00,27,Friday,171,60,18,1,250,heavy
11:15,27,Friday,174,53,10,3,240,heavy
11:30,27,Friday,154,61,16,3,234,heavy
11:45,27,Friday,161,53,11,1,226,heavy
12:00,27,Friday,148,48,13,2,211,heavy
12:15,27,Friday,136,60,27,2,225,heavy
12:30,27,Friday,143,68,16,0,227,heavy
12:45,27,Friday,152,51,22,2,227,heavy
13:00,27,Friday,132,58,15,4,209,heavy
13:15,27,Friday,155,58,15,4,232,heavy
13:30,27,Friday,144,62,12,3,221,heavy
13:45,27,Friday,161,51,20,1,233,heavy
14:00,27,Friday,137,46,13,2,198,heavy
14:15,27,Friday,149,61,16,1,227,heavy
14:30,27,Friday,158,46,20,1,225,heavy
14:45,27,Friday,134,65,22,0,221,heavy
15:00,27,Friday,134,65,10,2,211,heavy
15:15,27,Friday,73,24,4,0,101,low
15:30,27,Friday,64,23,21,1,109,normal
15:45,27,Friday,51,27,25,2,105,normal
16:00,27,Friday,80,22,17,0,119,normal
16:15,27,Friday,61,26,8,0,95,low
16:30,27,Friday,75,24,8,0,107,low
16:45,27,Friday,82,20,15,2,119,normal
17:00,27,Friday,53,28,21,1,103,normal
17:15,27,Friday,68,29,14,0,111,low
17:30,27,Friday,63,28,22,0,113,normal
17:45,27,Friday,76,30,20,1,127,normal
18:00,27,Friday,66,23,10,0,99,low
18:15,27,Friday,50,23,1,0,74,low
18:30,27,Friday,60,29,22,2,113,normal
18:45,27,Friday,75,26,11,0,112,normal
19:00,27,Friday,81,22,18,2,123,normal
19:15,27,Friday,33,6,0,4,43,low
19:30,27,Friday,21,5,6,15,47,normal
19:45,27,Friday,22,7,1,2,32,low
20:00,27,Friday,31,6,0,15,52,normal
20:15,27,Friday,41,8,3,2,54,low
20:30,27,Friday,24,6,5,11,46,low
20:45,27,Friday,45,6,6,10,67,low
21:00,27,Friday,24,11,6,2,43,low
21:15,27,Friday,47,6,2,12,67,low
21:30,27,Friday,46,1,1,4,52,low
21:45,27,Friday,26,3,2,3,34,low
22:00,27,Friday,20,4,0,39,63,normal
22:15,27,Friday,20,1,1,27,49,normal
22:30,27,Friday,19,0,1,17,37,normal
22:45,27,Friday,11,3,1,19,34,normal
23:00,27,Friday,17,5,1,31,54,normal
23:15,27,Friday,19,4,0,12,35,low
23:30,27,Friday,11,1,0,38,50,normal
23:45,27,Friday,12,0,0,17,29,normal
0:00,28,Saturday,18,0,0,27,45,normal
0:15,28,Saturday,19,4,0,14,37,normal
0:30,28,Saturday,13,2,0,28,43,normal
0:45,28,Saturday,18,4,1,23,46,normal
1:00,28,Saturday,20,0,0,11,31,low
1:15,28,Saturday,11,4,1,22,38,normal
1:30,28,Saturday,15,2,0,18,35,normal
1:45,28,Saturday,16,3,0,34,53,normal
2:00,28,Saturday,11,2,0,18,31,normal
2:15,28,Saturday,17,4,1,38,60,normal
2:30,28,Saturday,20,4,1,28,53,normal
2:45,28,Saturday,19,0,1,37,57,normal
3:00,28,Saturday,10,2,1,34,47,normal
3:15,28,Saturday,19,0,0,17,36,normal
3:30,28,Saturday,15,0,0,30,45,normal
3:45,28,Saturday,10,2,0,31,43,normal
4:00,28,Saturday,18,3,0,17,38,normal
4:15,28,Saturday,97,22,4,18,141,normal
4:30,28,Saturday,111,12,9,17,149,normal
4:45,28,Saturday,108,10,5,17,140,normal
5:00,28,Saturday,74,24,10,20,128,normal
5:15,28,Saturday,114,4,8,20,146,normal
5:30,28,Saturday,91,16,5,11,123,normal
5:45,28,Saturday,66,3,9,19,97,normal
6:00,28,Saturday,104,32,23,5,164,normal
6:15,28,Saturday,128,18,31,3,180,heavy
6:30,28,Saturday,127,24,27,0,178,heavy
6:45,28,Saturday,130,31,22,0,183,heavy
7:00,28,Saturday,108,13,38,1,160,high
7:15,28,Saturday,116,22,37,2,177,heavy
7:30,28,Saturday,143,28,27,4,202,heavy
7:45,28,Saturday,118,32,21,5,176,heavy
8:00,28,Saturday,121,35,32,0,188,heavy
8:15,28,Saturday,109,28,39,2,178,heavy
8:30,28,Saturday,135,11,23,5,174,heavy
8:45,28,Saturday,100,30,29,2,161,high
9:00,28,Saturday,138,32,26,4,200,heavy
9:15,28,Saturday,29,9,21,23,82,normal
9:30,28,Saturday,36,17,7,30,90,normal
9:45,28,Saturday,42,9,37,28,116,high
10:00,28,Saturday,80,6,12,6,104,low
10:15,28,Saturday,37,21,28,6,92,normal
10:30,28,Saturday,44,17,27,30,118,high
10:45,28,Saturday,25,12,13,5,55,low
11:00,28,Saturday,36,9,9,30,84,normal
11:15,28,Saturday,63,7,10,29,109,normal
11:30,28,Saturday,20,5,13,22,60,normal
11:45,28,Saturday,53,8,6,23,90,normal
12:00,28,Saturday,41,7,5,26,79,normal
12:15,28,Saturday,36,9,13,29,87,normal
12:30,28,Saturday,65,10,8,22,105,normal
12:45,28,Saturday,55,6,5,27,93,normal
13:00,28,Saturday,63,8,15,30,116,high
13:15,28,Saturday,19,26,32,18,95,normal
13:30,28,Saturday,84,11,11,9,115,normal
13:45,28,Saturday,110,23,34,9,176,heavy
14:00,28,Saturday,46,20,18,5,89,normal
14:15,28,Saturday,67,12,10,20,109,normal
14:30,28,Saturday,42,25,20,19,106,normal
14:45,28,Saturday,87,17,18,6,128,normal
15:00,28,Saturday,45,24,31,11,111,normal
15:15,28,Saturday,80,26,35,6,147,high
15:30,28,Saturday,83,18,6,15,122,normal
15:45,28,Saturday,68,19,15,11,113,normal
16:00,28,Saturday,101,37,48,9,195,heavy
16:15,28,Saturday,149,32,29,10,220,heavy
16:30,28,Saturday,136,21,33,9,199,heavy
16:45,28,Saturday,105,20,23,7,155,normal
17:00,28,Saturday,125,12,20,8,165,normal
17:15,28,Saturday,125,14,26,5,170,heavy
17:30,28,Saturday,118,28,23,8,177,heavy
17:45,28,Saturday,114,32,45,6,197,heavy
18:00,28,Saturday,123,37,46,8,214,heavy
18:15,28,Saturday,115,23,22,7,167,normal
18:30,28,Saturday,111,25,35,10,181,heavy
18:45,28,Saturday,66,8,11,9,94,low
19:00,28,Saturday,103,12,17,23,155,high
19:15,28,Saturday,94,14,14,24,146,high
19:30,28,Saturday,105,23,15,18,161,normal
19:45,28,Saturday,53,22,14,35,124,high
20:00,28,Saturday,74,10,12,32,128,high
20:15,28,Saturday,71,24,15,26,136,high
20:30,28,Saturday,61,21,15,32,129,high
20:45,28,Saturday,101,25,18,8,152,normal
21:00,28,Saturday,104,22,10,14,150,normal
21:15,28,Saturday,79,20,15,18,132,normal
21:30,28,Saturday,70,20,11,14,115,normal
21:45,28,Saturday,74,16,14,34,138,high
22:00,28,Saturday,20,5,0,21,46,normal
22:15,28,Saturday,16,0,0,36,52,normal
22:30,28,Saturday,14,3,0,20,37,normal
22:45,28,Saturday,14,1,1,30,46,normal
23:00,28,Saturday,17,0,1,12,30,low
23:15,28,Saturday,14,0,0,14,28,normal
23:30,28,Saturday,18,5,0,40,63,normal
23:45,28,Saturday,17,2,0,18,37,normal
0:00,29,Sunday,14,1,1,35,51,normal
0:15,29,Sunday,14,2,1,26,43,normal
0:30,29,Sunday,16,0,1,37,54,normal
0:45,29,Sunday,14,4,1,32,51,normal
1:00,29,Sunday,19,5,0,12,36,low
1:15,29,Sunday,11,0,1,31,43,normal
1:30,29,Sunday,12,0,0,32,44,normal
1:45,29,Sunday,12,3,0,32,47,normal
2:00,29,Sunday,18,4,1,31,54,normal
2:15,29,Sunday,17,4,1,20,42,normal
2:30,29,Sunday,17,0,0,22,39,normal
2:45,29,Sunday,19,2,1,12,34,low
3:00,29,Sunday,18,2,1,19,40,normal
3:15,29,Sunday,19,5,0,26,50,normal
3:30,29,Sunday,19,5,1,35,60,normal
3:45,29,Sunday,18,0,0,20,38,normal
4:00,29,Sunday,16,0,0,30,46,normal
4:15,29,Sunday,114,30,9,7,160,normal
4:30,29,Sunday,102,17,2,14,135,normal
4:45,29,Sunday,55,4,7,13,79,normal
5:00,29,Sunday,82,2,4,14,102,normal
5:15,29,Sunday,66,16,9,19,110,normal
5:30,29,Sunday,86,5,1,13,105,normal
5:45,29,Sunday,108,24,2,19,153,normal
6:00,29,Sunday,112,30,26,0,168,heavy
6:15,29,Sunday,147,31,46,0,224,heavy
6:30,29,Sunday,116,20,40,2,178,heavy
6:45,29,Sunday,138,13,21,5,177,heavy
7:00,29,Sunday,132,25,40,2,199,heavy
7:15,29,Sunday,124,14,31,4,173,heavy
7:30,29,Sunday,106,27,25,1,159,normal
7:45,29,Sunday,104,24,29,5,162,high
8:00,29,Sunday,140,31,21,4,196,heavy
8:15,29,Sunday,121,35,37,3,196,heavy
8:30,29,Sunday,135,23,37,5,200,heavy
8:45,29,Sunday,149,20,30,5,204,heavy
9:00,29,Sunday,117,14,39,0,170,heavy
9:15,29,Sunday,39,8,23,13,83,normal
9:30,29,Sunday,40,14,18,21,93,normal
9:45,29,Sunday,49,1,35,18,103,normal
10:00,29,Sunday,38,12,35,25,110,normal
10:15,29,Sunday,26,15,25,6,72,normal
10:30,29,Sunday,93,14,10,25,142,high
10:45,29,Sunday,54,24,37,20,135,high
11:00,29,Sunday,32,6,10,23,71,normal
11:15,29,Sunday,43,7,12,23,85,normal
11:30,29,Sunday,23,6,15,20,64,normal
11:45,29,Sunday,26,5,8,25,64,normal
12:00,29,Sunday,55,7,8,27,97,normal
12:15,29,Sunday,70,10,8,25,113,high
12:30,29,Sunday,66,10,3,29,108,normal
12:45,29,Sunday,66,7,15,26,114,high
13:00,29,Sunday,46,6,7,21,80,normal
13:15,29,Sunday,47,26,6,20,99,normal
13:30,29,Sunday,75,20,7,11,113,normal
13:45,29,Sunday,76,29,15,19,139,normal
14:00,29,Sunday,56,14,38,12,120,high
14:15,29,Sunday,19,26,36,17,98,normal
14:30,29,Sunday,29,18,10,9,66,low
14:45,29,Sunday,15,12,18,15,60,normal
15:00,29,Sunday,53,27,27,17,124,high
15:15,29,Sunday,95,22,28,9,154,high
15:30,29,Sunday,27,27,32,10,96,normal
15:45,29,Sunday,68,28,31,15,142,high
16:00,29,Sunday,120,14,25,8,167,normal
16:15,29,Sunday,144,28,24,8,204,heavy
16:30,29,Sunday,112,31,43,8,194,heavy
16:45,29,Sunday,149,28,20,10,207,heavy
17:00,29,Sunday,131,29,34,8,202,heavy
17:15,29,Sunday,104,31,41,9,185,heavy
17:30,29,Sunday,141,30,27,7,205,heavy
17:45,29,Sunday,117,10,47,9,183,heavy
18:00,29,Sunday,112,13,37,6,168,heavy
18:15,29,Sunday,127,40,39,8,214,heavy
18:30,29,Sunday,131,15,31,6,183,heavy
18:45,29,Sunday,66,8,10,11,95,low
19:00,29,Sunday,61,23,18,34,136,high
19:15,29,Sunday,55,25,13,26,119,high
19:30,29,Sunday,85,23,20,6,134,normal
19:45,29,Sunday,75,20,19,19,133,normal
20:00,29,Sunday,58,17,20,22,117,high
20:15,29,Sunday,60,23,11,26,120,high
20:30,29,Sunday,80,21,11,7,119,normal
20:45,29,Sunday,74,9,14,35,132,high
21:00,29,Sunday,57,14,11,16,98,normal
21:15,29,Sunday,73,9,13,5,100,low
21:30,29,Sunday,80,25,19,26,150,high
21:45,29,Sunday,82,13,12,21,128,high
22:00,29,Sunday,15,4,0,27,46,normal
22:15,29,Sunday,20,2,0,29,51,normal
22:30,29,Sunday,12,2,0,39,53,normal
22:45,29,Sunday,10,4,1,13,28,normal
23:00,29,Sunday,16,0,1,29,46,normal
23:15,29,Sunday,18,0,0,34,52,normal
23:30,29,Sunday,11,5,1,19,36,normal
23:45,29,Sunday,16,1,0,12,29,low
0:00,30,Monday,13,3,1,12,29,low
0:15,30,Monday,19,2,0,22,43,normal
0:30,30,Monday,13,3,0,39,55,normal
0:45,30,Monday,12,0,0,24,36,normal
1:00,30,Monday,10,3,1,12,26,low
1:15,30,Monday,11,4,0,38,53,normal
1:30,30,Monday,18,4,0,31,53,normal
1:45,30,Monday,19,1,0,34,54,normal
2:00,30,Monday,18,1,0,27,46,normal
2:15,30,Monday,13,0,0,26,39,normal
2:30,30,Monday,12,2,0,35,49,normal
2:45,30,Monday,15,4,0,12,31,low
3:00,30,Monday,10,5,0,33,48,normal
3:15,30,Monday,14,0,0,15,29,normal
3:30,30,Monday,16,0,0,16,32,normal
3:45,30,Monday,15,3,1,26,45,normal
4:00,30,Monday,20,4,0,34,58,normal
4:15,30,Monday,82,20,10,11,123,normal
4:30,30,Monday,99,7,3,6,115,normal
4:45,30,Monday,74,29,9,4,116,normal
5:00,30,Monday,94,1,1,14,110,normal
5:15,30,Monday,63,12,10,17,102,normal
5:30,30,Monday,101,4,3,12,120,normal
5:45,30,Monday,106,9,3,10,128,normal
6:00,30,Monday,112,15,24,1,152,normal
6:15,30,Monday,148,26,25,0,199,heavy
6:30,30,Monday,115,20,31,3,169,heavy
6:45,30,Monday,125,11,24,0,160,normal
7:00,30,Monday,140,38,38,0,216,heavy
7:15,30,Monday,150,17,35,5,207,heavy
7:30,30,Monday,149,11,42,2,204,heavy
7:45,30,Monday,150,22,38,3,213,heavy
8:00,30,Monday,147,32,25,4,208,heavy
8:15,30,Monday,138,39,45,4,226,heavy
8:30,30,Monday,149,16,49,1,215,heavy
8:45,30,Monday,139,10,50,2,201,heavy
9:00,30,Monday,109,25,49,2,185,heavy
9:15,30,Monday,84,24,12,28,148,high
9:30,30,Monday,38,8,6,5,57,low
9:45,30,Monday,45,16,6,21,88,normal
10:00,30,Monday,57,4,36,14,111,normal
10:15,30,Monday,84,12,6,28,130,high
10:30,30,Monday,55,25,33,21,134,high
10:45,30,Monday,14,15,5,21,55,normal
11:00,30,Monday,26,8,11,20,65,normal
11:15,30,Monday,60,10,9,27,106,normal
11:30,30,Monday,34,6,7,25,72,normal
11:45,30,Monday,22,9,8,26,65,normal
12:00,30,Monday,59,10,11,30,110,normal
12:15,30,Monday,48,6,14,28,96,normal
12:30,30,Monday,46,9,11,23,89,normal
12:45,30,Monday,37,9,8,20,74,normal
13:00,30,Monday,67,9,11,21,108,normal
13:15,30,Monday,32,19,39,9,99,normal
13:30,30,Monday,63,12,22,5,102,normal
13:45,30,Monday,32,29,25,11,97,normal
14:00,30,Monday,83,22,40,20,165,high
14:15,30,Monday,40,14,31,19,104,normal
14:30,30,Monday,101,22,39,19,181,heavy
14:45,30,Monday,62,29,31,11,133,high
15:00,30,Monday,20,19,25,8,72,normal
15:15,30,Monday,42,22,5,9,78,low
15:30,30,Monday,37,17,12,16,82,normal
15:45,30,Monday,95,12,20,15,142,normal
16:00,30,Monday,137,14,41,10,202,heavy
16:15,30,Monday,122,21,20,10,173,heavy
16:30,30,Monday,104,19,39,9,171,heavy
16:45,30,Monday,147,21,40,9,217,heavy
17:00,30,Monday,105,38,34,7,184,heavy
17:15,30,Monday,124,23,46,5,198,heavy
17:30,30,Monday,135,18,20,5,178,heavy
17:45,30,Monday,107,35,23,8,173,heavy
18:00,30,Monday,109,21,24,10,164,normal
18:15,30,Monday,136,32,26,8,202,heavy
18:30,30,Monday,134,23,49,8,214,heavy
18:45,30,Monday,90,20,11,25,146,high
19:00,30,Monday,104,5,16,16,141,normal
19:15,30,Monday,60,21,13,6,100,low
19:30,30,Monday,104,22,11,13,150,normal
19:45,30,Monday,54,23,10,25,112,high
20:00,30,Monday,68,6,15,34,123,high
20:15,30,Monday,88,13,19,19,139,normal
20:30,30,Monday,64,22,16,16,118,normal
20:45,30,Monday,58,24,14,24,120,high
21:00,30,Monday,67,19,12,9,107,low
21:15,30,Monday,73,20,18,7,118,normal
21:30,30,Monday,109,25,16,20,170,heavy
21:45,30,Monday,63,15,11,23,112,high
22:00,30,Monday,19,4,1,26,50,normal
22:15,30,Monday,15,1,0,34,50,normal
22:30,30,Monday,15,5,1,14,35,normal
22:45,30,Monday,19,3,1,33,56,normal
23:00,30,Monday,18,4,0,11,33,low
23:15,30,Monday,14,1,0,27,42,normal
23:30,30,Monday,19,0,0,37,56,normal
23:45,30,Monday,19,0,0,29,48,normal
0:00,31,Tuesday,18,1,0,30,49,normal
0:15,31,Tuesday,19,3,0,18,40,normal
0:30,31,Tuesday,15,2,1,34,52,normal
0:45,31,Tuesday,17,0,1,14,32,normal
1:00,31,Tuesday,12,0,0,33,45,normal
1:15,31,Tuesday,20,0,1,20,41,normal
1:30,31,Tuesday,10,2,0,18,30,normal
1:45,31,Tuesday,13,3,0,31,47,normal
2:00,31,Tuesday,10,0,1,38,49,normal
2:15,31,Tuesday,19,1,1,28,49,normal
2:30,31,Tuesday,19,4,0,16,39,normal
2:45,31,Tuesday,16,1,0,15,32,normal
3:00,31,Tuesday,17,1,0,34,52,normal
3:15,31,Tuesday,19,1,0,21,41,normal
3:30,31,Tuesday,10,1,0,39,50,normal
3:45,31,Tuesday,16,4,0,15,35,normal
4:00,31,Tuesday,13,0,0,16,29,normal
4:15,31,Tuesday,98,5,1,17,121,normal
4:30,31,Tuesday,65,10,3,8,86,low
4:45,31,Tuesday,98,17,0,20,135,normal
5:00,31,Tuesday,60,20,5,6,91,low
5:15,31,Tuesday,110,18,10,11,149,normal
5:30,31,Tuesday,70,13,4,13,100,normal
5:45,31,Tuesday,96,12,7,17,132,normal
6:00,31,Tuesday,129,31,36,1,197,heavy
6:15,31,Tuesday,146,28,47,3,224,heavy
6:30,31,Tuesday,137,23,27,0,187,heavy
6:45,31,Tuesday,131,28,24,0,183,heavy
7:00,31,Tuesday,134,10,44,0,188,heavy
7:15,31,Tuesday,109,25,24,0,158,normal
7:30,31,Tuesday,108,35,22,3,168,heavy
7:45,31,Tuesday,146,14,37,2,199,heavy
8:00,31,Tuesday,147,21,41,5,214,heavy
8:15,31,Tuesday,110,34,35,0,179,heavy
8:30,31,Tuesday,110,40,50,2,202,heavy
8:45,31,Tuesday,123,12,22,3,160,normal
9:00,31,Tuesday,145,25,20,5,195,heavy
9:15,31,Tuesday,82,15,16,29,142,high
9:30,31,Tuesday,62,2,7,22,93,normal
9:45,31,Tuesday,92,8,11,21,132,high
10:00,31,Tuesday,35,22,22,18,97,normal
10:15,31,Tuesday,66,25,13,13,117,normal
10:30,31,Tuesday,50,2,25,12,89,normal
10:45,31,Tuesday,50,22,24,7,103,normal
11:00,31,Tuesday,50,8,5,24,87,normal
11:15,31,Tuesday,55,5,5,21,86,normal
11:30,31,Tuesday,51,10,14,24,99,normal
11:45,31,Tuesday,34,8,14,21,77,normal
12:00,31,Tuesday,25,7,5,20,57,normal
12:15,31,Tuesday,59,7,9,21,96,normal
12:30,31,Tuesday,38,10,9,24,81,normal
12:45,31,Tuesday,70,10,9,23,112,high
13:00,31,Tuesday,63,8,13,22,106,normal
13:15,31,Tuesday,6,24,12,13,55,normal
13:30,31,Tuesday,108,17,16,16,157,normal
13:45,31,Tuesday,41,20,32,12,105,normal
14:00,31,Tuesday,54,10,20,9,93,normal
14:15,31,Tuesday,60,19,14,7,100,low
14:30,31,Tuesday,102,11,9,11,133,normal
14:45,31,Tuesday,50,24,30,5,109,normal
15:00,31,Tuesday,25,24,19,10,78,normal
15:15,31,Tuesday,90,25,18,20,153,normal
15:30,31,Tuesday,86,13,27,11,137,high
15:45,31,Tuesday,44,19,17,9,89,normal
16:00,31,Tuesday,126,24,35,8,193,heavy
16:15,31,Tuesday,146,26,42,9,223,normal
16:30,31,Tuesday,117,28,33,10,188,heavy
16:45,31,Tuesday,144,36,49,10,239,heavy
17:00,31,Tuesday,137,19,23,9,188,heavy
17:15,31,Tuesday,118,19,48,5,190,heavy
17:30,31,Tuesday,119,27,28,8,182,heavy
17:45,31,Tuesday,149,26,43,5,223,normal
18:00,31,Tuesday,117,34,36,10,197,heavy
18:15,31,Tuesday,124,30,44,10,208,heavy
18:30,31,Tuesday,141,36,48,5,230,heavy
18:45,31,Tuesday,78,6,11,28,123,high
19:00,31,Tuesday,102,23,16,24,165,high
19:15,31,Tuesday,104,18,18,23,163,high
19:30,31,Tuesday,95,9,19,7,130,normal
19:45,31,Tuesday,105,13,12,20,150,normal
20:00,31,Tuesday,100,18,16,34,168,heavy
20:15,31,Tuesday,80,14,20,15,129,normal
20:30,31,Tuesday,86,8,19,7,120,normal
20:45,31,Tuesday,108,20,14,15,157,normal
21:00,31,Tuesday,69,13,13,8,103,low
21:15,31,Tuesday,64,14,10,6,94,low
21:30,31,Tuesday,71,14,17,10,112,normal
21:45,31,Tuesday,61,9,18,24,112,high
22:00,31,Tuesday,11,4,0,31,46,normal
22:15,31,Tuesday,17,5,0,14,36,normal
22:30,31,Tuesday,15,5,0,18,38,normal
22:45,31,Tuesday,14,2,0,40,56,normal
23:00,31,Tuesday,12,2,1,28,43,normal
23:15,31,Tuesday,18,0,1,40,59,normal
23:30,31,Tuesday,14,5,0,13,32,normal
23:45,31,Tuesday,18,1,0,26,45,normal
0:00,1,Wednesday,14,0,0,34,48,normal
0:15,1,Wednesday,17,5,0,23,45,normal
0:30,1,Wednesday,19,1,1,18,39,normal
0:45,1,Wednesday,15,5,1,12,33,low
1:00,1,Wednesday,13,2,1,26,42,normal
1:15,1,Wednesday,15,3,0,32,50,normal
1:30,1,Wednesday,15,0,1,13,29,normal
1:45,1,Wednesday,18,5,1,12,36,low
2:00,1,Wednesday,17,1,0,29,47,normal
2:15,1,Wednesday,10,4,0,19,33,normal
2:30,1,Wednesday,15,0,0,18,33,normal
2:45,1,Wednesday,11,0,0,35,46,normal
3:00,1,Wednesday,20,5,1,34,60,normal
3:15,1,Wednesday,15,5,1,32,53,normal
3:30,1,Wednesday,16,4,1,37,58,normal
3:45,1,Wednesday,14,1,0,12,27,low
4:00,1,Wednesday,16,4,0,18,38,normal
4:15,1,Wednesday,56,21,3,0,80,low
4:30,1,Wednesday,78,11,10,18,117,normal
4:45,1,Wednesday,82,29,0,20,131,normal
5:00,1,Wednesday,102,15,2,7,126,normal
5:15,1,Wednesday,69,14,6,18,107,normal
5:30,1,Wednesday,87,24,6,19,136,normal
5:45,1,Wednesday,84,16,10,5,115,normal
6:00,1,Wednesday,109,38,34,5,186,heavy
6:15,1,Wednesday,147,38,23,3,211,heavy
6:30,1,Wednesday,135,19,48,5,207,heavy
6:45,1,Wednesday,101,23,41,5,170,heavy
7:00,1,Wednesday,138,21,28,1,188,heavy
7:15,1,Wednesday,136,20,32,1,189,heavy
7:30,1,Wednesday,123,19,25,5,172,heavy
7:45,1,Wednesday,108,30,46,5,189,heavy
8:00,1,Wednesday,128,15,43,5,191,heavy
8:15,1,Wednesday,129,37,41,1,208,heavy
8:30,1,Wednesday,127,18,28,3,176,heavy
8:45,1,Wednesday,142,37,46,3,228,heavy
9:00,1,Wednesday,149,26,46,1,222,heavy
9:15,1,Wednesday,77,13,7,23,120,high
9:30,1,Wednesday,37,16,13,29,95,normal
9:45,1,Wednesday,79,8,16,12,115,normal
10:00,1,Wednesday,97,2,16,7,122,normal
10:15,1,Wednesday,22,8,31,8,69,normal
10:30,1,Wednesday,31,23,19,12,85,normal
10:45,1,Wednesday,49,22,16,5,92,normal
11:00,1,Wednesday,32,5,3,21,61,normal
11:15,1,Wednesday,40,6,11,28,85,normal
11:30,1,Wednesday,42,6,10,21,79,normal
11:45,1,Wednesday,37,9,7,25,78,normal
12:00,1,Wednesday,45,5,5,24,79,normal
12:15,1,Wednesday,64,10,4,28,106,normal
12:30,1,Wednesday,33,8,6,23,70,normal
12:45,1,Wednesday,34,6,12,27,79,normal
13:00,1,Wednesday,40,9,5,20,74,normal
13:15,1,Wednesday,64,19,22,12,117,normal
13:30,1,Wednesday,108,24,34,7,173,heavy
13:45,1,Wednesday,108,17,33,7,165,high
14:00,1,Wednesday,50,23,21,11,105,normal
14:15,1,Wednesday,16,21,10,16,63,normal
14:30,1,Wednesday,91,22,34,8,155,high
14:45,1,Wednesday,89,19,37,18,163,high
15:00,1,Wednesday,108,12,23,8,151,normal
15:15,1,Wednesday,73,29,23,7,132,normal
15:30,1,Wednesday,76,28,39,14,157,high
15:45,1,Wednesday,19,15,20,17,71,normal
16:00,1,Wednesday,102,37,48,9,196,heavy
16:15,1,Wednesday,115,36,41,8,200,heavy
16:30,1,Wednesday,142,23,23,6,194,heavy
16:45,1,Wednesday,134,15,29,8,186,heavy
17:00,1,Wednesday,146,18,49,9,222,heavy
17:15,1,Wednesday,126,24,48,9,207,heavy
17:30,1,Wednesday,138,18,27,6,189,heavy
17:45,1,Wednesday,129,13,43,6,191,heavy
18:00,1,Wednesday,127,35,23,10,195,heavy
18:15,1,Wednesday,144,20,22,7,193,heavy
18:30,1,Wednesday,117,19,31,7,174,heavy
18:45,1,Wednesday,87,10,13,16,126,normal
19:00,1,Wednesday,87,6,18,30,141,high
19:15,1,Wednesday,97,18,10,24,149,high
19:30,1,Wednesday,71,21,14,12,118,normal
19:45,1,Wednesday,96,24,18,10,148,normal
20:00,1,Wednesday,90,7,17,31,145,high
20:15,1,Wednesday,74,6,12,34,126,high
20:30,1,Wednesday,59,7,15,20,101,normal
20:45,1,Wednesday,87,11,16,28,142,high
21:00,1,Wednesday,62,22,20,20,124,normal
21:15,1,Wednesday,71,16,14,9,110,low
21:30,1,Wednesday,98,9,15,18,140,normal
21:45,1,Wednesday,93,8,10,16,127,normal
22:00,1,Wednesday,17,4,0,36,57,normal
22:15,1,Wednesday,16,1,1,29,47,normal
22:30,1,Wednesday,15,2,0,10,27,low
22:45,1,Wednesday,10,3,1,23,37,normal
23:00,1,Wednesday,12,4,0,31,47,normal
23:15,1,Wednesday,20,1,1,24,46,normal
23:30,1,Wednesday,11,0,1,23,35,normal
23:45,1,Wednesday,14,1,1,17,33,normal
0:00,2,Thursday,12,5,1,38,56,normal
0:15,2,Thursday,15,4,1,29,49,normal
0:30,2,Thursday,12,4,0,40,56,normal
0:45,2,Thursday,11,5,0,22,38,normal
1:00,2,Thursday,14,5,1,21,41,normal
1:15,2,Thursday,14,3,0,39,56,normal
1:30,2,Thursday,10,4,1,11,26,low
1:45,2,Thursday,11,0,0,16,27,normal
2:00,2,Thursday,12,3,0,39,54,normal
2:15,2,Thursday,11,0,1,36,48,normal
2:30,2,Thursday,16,2,0,35,53,normal
2:45,2,Thursday,17,3,1,36,57,normal
3:00,2,Thursday,13,1,1,13,28,normal
3:15,2,Thursday,14,5,0,19,38,normal
3:30,2,Thursday,17,5,1,15,38,normal
3:45,2,Thursday,19,3,0,13,35,normal
4:00,2,Thursday,19,3,1,12,35,low
4:15,2,Thursday,54,15,10,8,87,low
4:30,2,Thursday,107,0,1,2,110,low
4:45,2,Thursday,116,20,5,14,155,normal
5:00,2,Thursday,78,2,4,9,93,low
5:15,2,Thursday,111,22,0,12,145,normal
5:30,2,Thursday,85,27,7,17,136,normal
5:45,2,Thursday,95,5,9,20,129,normal
6:00,2,Thursday,143,33,27,1,204,heavy
6:15,2,Thursday,133,40,37,0,210,heavy
6:30,2,Thursday,123,37,34,4,198,heavy
6:45,2,Thursday,133,34,36,1,204,heavy
7:00,2,Thursday,101,20,42,4,167,normal
7:15,2,Thursday,145,10,37,0,192,heavy
7:30,2,Thursday,141,39,40,5,225,heavy
7:45,2,Thursday,134,12,22,2,170,heavy
8:00,2,Thursday,126,10,26,4,166,high
8:15,2,Thursday,136,22,31,0,189,heavy
8:30,2,Thursday,128,26,42,4,200,heavy
8:45,2,Thursday,106,12,28,4,150,high
9:00,2,Thursday,140,27,36,2,205,heavy
9:15,2,Thursday,40,20,37,28,125,high
9:30,2,Thursday,13,25,33,12,83,normal
9:45,2,Thursday,18,22,26,10,76,normal
10:00,2,Thursday,59,5,36,12,112,high
10:15,2,Thursday,48,9,30,14,101,normal
10:30,2,Thursday,77,23,14,20,134,normal
10:45,2,Thursday,17,13,13,27,70,normal
11:00,2,Thursday,36,5,14,25,80,normal
11:15,2,Thursday,60,10,3,28,101,normal
11:30,2,Thursday,34,5,4,29,72,normal
11:45,2,Thursday,63,5,6,20,94,normal
12:00,2,Thursday,48,10,13,23,94,normal
12:15,2,Thursday,44,5,5,21,75,normal
12:30,2,Thursday,62,5,14,23,104,normal
12:45,2,Thursday,38,8,15,27,88,normal
13:00,2,Thursday,26,6,9,29,70,normal
13:15,2,Thursday,78,23,16,13,130,normal
13:30,2,Thursday,116,21,22,17,176,heavy
13:45,2,Thursday,94,13,11,16,134,normal
14:00,2,Thursday,52,19,26,10,107,normal
14:15,2,Thursday,70,13,12,10,105,low
14:30,2,Thursday,34,17,21,14,86,normal
14:45,2,Thursday,16,18,40,6,80,normal
15:00,2,Thursday,24,20,15,17,76,normal
15:15,2,Thursday,21,15,33,12,81,normal
15:30,2,Thursday,100,10,18,7,135,normal
15:45,2,Thursday,117,22,11,5,155,normal
16:00,2,Thursday,145,30,40,8,223,normal
16:15,2,Thursday,113,38,45,7,203,heavy
16:30,2,Thursday,110,31,37,7,185,heavy
16:45,2,Thursday,126,15,26,6,173,heavy
17:00,2,Thursday,100,15,29,7,151,high
17:15,2,Thursday,147,28,29,10,214,heavy
17:30,2,Thursday,146,22,50,10,228,heavy
17:45,2,Thursday,148,23,27,5,203,heavy
18:00,2,Thursday,149,17,41,9,216,heavy
18:15,2,Thursday,136,32,41,7,216,heavy
18:30,2,Thursday,101,22,33,9,165,high
18:45,2,Thursday,87,18,13,34,152,high
19:00,2,Thursday,50,21,14,9,94,low
19:15,2,Thursday,63,23,19,34,139,high
19:30,2,Thursday,73,9,11,5,98,low
19:45,2,Thursday,78,13,20,25,136,high
20:00,2,Thursday,71,22,12,14,119,normal
20:15,2,Thursday,80,17,11,15,123,normal
20:30,2,Thursday,62,21,10,35,128,high
20:45,2,Thursday,100,17,16,33,166,high
21:00,2,Thursday,95,15,18,9,137,normal
21:15,2,Thursday,102,14,15,34,165,high
21:30,2,Thursday,68,12,15,32,127,high
21:45,2,Thursday,74,5,19,5,103,normal
22:00,2,Thursday,15,4,1,21,41,normal
22:15,2,Thursday,16,0,1,24,41,normal
22:30,2,Thursday,12,0,0,12,24,low
22:45,2,Thursday,12,5,0,23,40,normal
23:00,2,Thursday,15,2,1,14,32,normal
23:15,2,Thursday,10,3,0,23,36,normal
23:30,2,Thursday,16,2,0,35,53,normal
23:45,2,Thursday,13,3,0,22,38,normal
0:00,3,Friday,13,0,0,32,45,normal
0:15,3,Friday,11,1,0,27,39,normal
0:30,3,Friday,17,1,0,32,50,normal
0:45,3,Friday,11,2,0,17,30,normal
1:00,3,Friday,14,1,1,11,27,low
1:15,3,Friday,17,2,0,33,52,normal
1:30,3,Friday,15,2,1,38,56,normal
1:45,3,Friday,13,4,1,24,42,normal
2:00,3,Friday,11,5,1,11,28,low
2:15,3,Friday,12,3,0,22,37,normal
2:30,3,Friday,15,1,0,26,42,normal
2:45,3,Friday,13,0,1,34,48,normal
3:00,3,Friday,17,5,0,15,37,normal
3:15,3,Friday,20,3,1,26,50,normal
3:30,3,Friday,18,4,0,30,52,normal
3:45,3,Friday,12,1,1,19,33,normal
4:00,3,Friday,20,0,0,12,32,low
4:15,3,Friday,29,10,0,12,51,low
4:30,3,Friday,39,20,1,10,70,low
4:45,3,Friday,76,9,7,13,105,normal
5:00,3,Friday,33,17,0,13,63,normal
5:15,3,Friday,64,14,1,12,91,low
5:30,3,Friday,44,7,1,11,63,low
5:45,3,Friday,53,8,4,15,80,normal
6:00,3,Friday,75,6,7,13,101,normal
6:15,3,Friday,60,11,4,10,85,low
6:30,3,Friday,35,14,2,14,65,normal
6:45,3,Friday,75,20,6,15,116,normal
7:00,3,Friday,27,10,2,12,51,low
7:15,3,Friday,61,20,7,14,102,normal
7:30,3,Friday,72,20,5,15,112,normal
7:45,3,Friday,43,18,6,14,81,normal
8:00,3,Friday,54,10,4,14,82,normal
8:15,3,Friday,30,12,1,14,57,normal
8:30,3,Friday,72,8,6,12,98,low
8:45,3,Friday,55,17,7,15,94,normal
9:00,3,Friday,36,20,0,13,69,normal
9:15,3,Friday,168,55,10,0,233,heavy
9:30,3,Friday,135,61,28,2,226,heavy
9:45,3,Friday,168,68,27,2,265,heavy
10:00,3,Friday,139,44,16,1,200,heavy
10:15,3,Friday,156,63,12,3,234,heavy
10:30,3,Friday,141,51,27,3,222,heavy
10:45,3,Friday,144,44,16,3,207,heavy
11:00,3,Friday,132,65,23,0,220,heavy
11:15,3,Friday,180,48,17,2,247,heavy
11:30,3,Friday,140,67,20,4,231,heavy
11:45,3,Friday,163,62,12,0,237,heavy
12:00,3,Friday,148,70,15,0,233,heavy
12:15,3,Friday,134,47,22,3,206,heavy
12:30,3,Friday,162,51,13,0,226,heavy
12:45,3,Friday,136,49,15,1,201,heavy
13:00,3,Friday,147,52,26,0,225,heavy
13:15,3,Friday,174,54,25,1,254,heavy
13:30,3,Friday,135,69,20,1,225,heavy
13:45,3,Friday,142,55,21,1,219,heavy
14:00,3,Friday,144,59,14,2,219,heavy
14:15,3,Friday,180,49,17,0,246,heavy
14:30,3,Friday,153,59,20,4,236,heavy
14:45,3,Friday,139,43,27,3,212,heavy
15:00,3,Friday,179,60,12,0,251,heavy
15:15,3,Friday,76,21,6,1,104,low
15:30,3,Friday,59,25,19,1,104,normal
15:45,3,Friday,51,20,12,1,84,low
16:00,3,Friday,78,24,19,2,123,normal
16:15,3,Friday,50,24,11,0,85,low
16:30,3,Friday,59,25,8,0,92,low
16:45,3,Friday,90,21,0,0,111,low
17:00,3,Friday,79,26,21,2,128,normal
17:15,3,Friday,56,21,4,1,82,low
17:30,3,Friday,70,25,11,2,108,low
17:45,3,Friday,54,27,21,2,104,normal
18:00,3,Friday,53,22,13,2,90,low
18:15,3,Friday,59,27,5,2,93,low
18:30,3,Friday,63,30,21,0,114,normal
18:45,3,Friday,87,21,16,0,124,normal
19:00,3,Friday,71,26,19,1,117,normal
19:15,3,Friday,32,5,5,13,55,normal
19:30,3,Friday,36,6,7,2,51,low
19:45,3,Friday,35,10,0,2,47,low
20:00,3,Friday,40,10,5,10,65,low
20:15,3,Friday,44,6,1,3,54,low
20:30,3,Friday,40,6,1,3,50,low
20:45,3,Friday,45,2,7,7,61,low
21:00,3,Friday,44,2,6,5,57,low
21:15,3,Friday,33,4,4,5,46,low
21:30,3,Friday,22,5,3,13,43,normal
21:45,3,Friday,33,5,5,1,44,low
22:00,3,Friday,10,0,0,29,39,normal
22:15,3,Friday,19,3,1,35,58,normal
22:30,3,Friday,10,4,0,30,44,normal
22:45,3,Friday,12,3,1,25,41,normal
23:00,3,Friday,12,1,0,40,53,normal
23:15,3,Friday,20,2,0,19,41,normal
23:30,3,Friday,18,4,1,11,34,low
23:45,3,Friday,19,1,1,37,58,normal
0:00,4,Saturday,13,2,0,25,40,normal
0:15,4,Saturday,16,4,1,15,36,normal
0:30,4,Saturday,10,4,1,16,31,normal
0:45,4,Saturday,18,3,0,19,40,normal
1:00,4,Saturday,15,5,0,10,30,low
1:15,4,Saturday,14,2,1,22,39,normal
1:30,4,Saturday,15,0,0,15,30,normal
1:45,4,Saturday,17,5,0,21,43,normal
2:00,4,Saturday,14,0,1,12,27,low
2:15,4,Saturday,10,1,0,11,22,low
2:30,4,Saturday,18,5,0,18,41,normal
2:45,4,Saturday,12,4,0,11,27,low
3:00,4,Saturday,17,0,1,30,48,normal
3:15,4,Saturday,20,1,0,28,49,normal
3:30,4,Saturday,19,5,1,38,63,normal
3:45,4,Saturday,15,0,0,36,51,normal
4:00,4,Saturday,10,2,0,30,42,normal
4:15,4,Saturday,74,4,4,13,95,normal
4:30,4,Saturday,96,29,6,17,148,normal
4:45,4,Saturday,109,16,6,12,143,normal
5:00,4,Saturday,113,6,9,10,138,normal
5:15,4,Saturday,90,24,8,20,142,normal
5:30,4,Saturday,106,19,10,17,152,normal
5:45,4,Saturday,96,7,6,4,113,normal
6:00,4,Saturday,102,21,42,3,168,heavy
6:15,4,Saturday,140,35,50,0,225,heavy
6:30,4,Saturday,105,33,29,4,171,heavy
6:45,4,Saturday,134,26,27,1,188,heavy
7:00,4,Saturday,123,35,45,1,204,heavy
7:15,4,Saturday,128,31,26,0,185,heavy
7:30,4,Saturday,105,32,43,0,180,heavy
7:45,4,Saturday,137,13,31,5,186,heavy
8:00,4,Saturday,148,37,46,2,233,heavy
8:15,4,Saturday,105,14,35,2,156,high
8:30,4,Saturday,148,17,42,5,212,heavy
8:45,4,Saturday,116,22,30,3,171,heavy
9:00,4,Saturday,143,28,46,1,218,heavy
9:15,4,Saturday,30,24,13,13,80,normal
9:30,4,Saturday,74,23,35,10,142,high
9:45,4,Saturday,67,5,36,17,125,high
10:00,4,Saturday,59,11,33,25,128,high
10:15,4,Saturday,34,21,39,16,110,normal
10:30,4,Saturday,72,24,10,9,115,normal
10:45,4,Saturday,73,12,32,5,122,high
11:00,4,Saturday,26,8,8,24,66,normal
11:15,4,Saturday,47,5,7,28,87,normal
11:30,4,Saturday,33,10,6,29,78,normal
11:45,4,Saturday,39,8,13,20,80,normal
12:00,4,Saturday,36,5,14,22,77,normal
12:15,4,Saturday,53,9,15,25,102,normal
12:30,4,Saturday,37,9,10,30,86,normal
12:45,4,Saturday,54,8,4,27,93,normal
13:00,4,Saturday,20,8,15,26,69,normal
13:15,4,Saturday,47,29,28,9,113,high
13:30,4,Saturday,51,27,10,20,108,normal
13:45,4,Saturday,114,11,40,20,185,heavy
14:00,4,Saturday,73,13,19,9,114,normal
14:15,4,Saturday,28,19,27,5,79,normal
14:30,4,Saturday,105,20,20,11,156,normal
14:45,4,Saturday,68,24,15,14,121,normal
15:00,4,Saturday,112,16,30,11,169,heavy
15:15,4,Saturday,120,30,28,15,193,heavy
15:30,4,Saturday,38,27,12,18,95,normal
15:45,4,Saturday,94,17,14,15,140,normal
16:00,4,Saturday,107,28,45,8,188,heavy
16:15,4,Saturday,100,16,49,7,172,heavy
16:30,4,Saturday,145,15,20,9,189,heavy
16:45,4,Saturday,133,17,22,8,180,heavy
17:00,4,Saturday,117,36,41,10,204,heavy
17:15,4,Saturday,113,26,26,8,173,heavy
17:30,4,Saturday,101,20,21,9,151,normal
17:45,4,Saturday,149,33,45,10,237,heavy
18:00,4,Saturday,134,35,26,7,202,heavy
18:15,4,Saturday,106,11,45,9,171,heavy
18:30,4,Saturday,121,37,34,6,198,heavy
18:45,4,Saturday,97,13,11,15,136,normal
19:00,4,Saturday,91,17,18,29,155,high
19:15,4,Saturday,57,16,13,19,105,normal
19:30,4,Saturday,110,10,10,20,150,normal
19:45,4,Saturday,71,14,17,30,132,high
20:00,4,Saturday,89,25,20,24,158,high
20:15,4,Saturday,87,16,15,14,132,normal
20:30,4,Saturday,106,12,16,9,143,normal
20:45,4,Saturday,78,10,19,20,127,normal
21:00,4,Saturday,61,10,16,27,114,high
21:15,4,Saturday,74,19,15,24,132,high
21:30,4,Saturday,56,20,11,25,112,high
21:45,4,Saturday,106,22,16,18,162,normal
22:00,4,Saturday,10,1,1,12,24,low
22:15,4,Saturday,12,4,1,33,50,normal
22:30,4,Saturday,16,4,0,16,36,normal
22:45,4,Saturday,18,1,0,18,37,normal
23:00,4,Saturday,19,2,0,36,57,normal
23:15,4,Saturday,18,4,1,35,58,normal
23:30,4,Saturday,17,0,0,31,48,normal
23:45,4,Saturday,18,1,0,16,35,normal
0:00,5,Sunday,15,4,0,37,56,normal
0:15,5,Sunday,11,5,0,14,30,normal
0:30,5,Sunday,11,5,0,22,38,normal
0:45,5,Sunday,12,2,1,37,52,normal
1:00,5,Sunday,18,1,1,34,54,normal
1:15,5,Sunday,19,1,0,11,31,low
1:30,5,Sunday,11,4,1,26,42,normal
1:45,5,Sunday,18,3,0,28,49,normal
2:00,5,Sunday,12,4,1,37,54,normal
2:15,5,Sunday,11,1,1,29,42,normal
2:30,5,Sunday,19,5,1,29,54,normal
2:45,5,Sunday,18,4,0,11,33,low
3:00,5,Sunday,16,4,0,29,49,normal
3:15,5,Sunday,19,4,1,33,57,normal
3:30,5,Sunday,15,3,1,12,31,low
3:45,5,Sunday,16,4,1,28,49,normal
4:00,5,Sunday,11,4,0,20,35,normal
4:15,5,Sunday,93,4,1,16,114,normal
4:30,5,Sunday,114,12,7,18,151,normal
4:45,5,Sunday,56,7,5,20,88,normal
5:00,5,Sunday,92,23,3,19,137,normal
5:15,5,Sunday,99,6,6,7,118,normal
5:30,5,Sunday,108,14,6,9,137,normal
5:45,5,Sunday,66,20,2,16,104,normal
6:00,5,Sunday,147,26,44,5,222,heavy
6:15,5,Sunday,139,27,29,1,196,heavy
6:30,5,Sunday,119,31,36,5,191,heavy
6:45,5,Sunday,114,30,21,2,167,normal
7:00,5,Sunday,103,27,21,4,155,normal
7:15,5,Sunday,105,17,29,4,155,high
7:30,5,Sunday,124,29,41,1,195,heavy
7:45,5,Sunday,118,19,34,1,172,heavy
8:00,5,Sunday,101,37,32,0,170,heavy
8:15,5,Sunday,109,11,48,1,169,heavy
8:30,5,Sunday,143,12,23,3,181,heavy
8:45,5,Sunday,143,40,30,0,213,heavy
9:00,5,Sunday,128,16,34,0,178,heavy
9:15,5,Sunday,14,25,14,16,69,normal
9:30,5,Sunday,99,10,11,15,135,normal
9:45,5,Sunday,67,1,22,14,104,normal
10:00,5,Sunday,42,2,29,9,82,normal
10:15,5,Sunday,92,3,33,21,149,high
10:30,5,Sunday,91,16,28,9,144,high
10:45,5,Sunday,25,9,10,28,72,normal
11:00,5,Sunday,37,5,12,29,83,normal
11:15,5,Sunday,55,6,12,29,102,normal
11:30,5,Sunday,49,8,8,26,91,normal
11:45,5,Sunday,69,9,3,20,101,normal
12:00,5,Sunday,38,6,6,24,74,normal
12:15,5,Sunday,40,8,12,21,81,normal
12:30,5,Sunday,53,5,3,20,81,normal
12:45,5,Sunday,21,8,4,28,61,normal
13:00,5,Sunday,24,7,4,20,55,normal
13:15,5,Sunday,47,24,24,9,104,normal
13:30,5,Sunday,90,30,32,8,160,high
13:45,5,Sunday,120,21,22,14,177,heavy
14:00,5,Sunday,120,12,40,13,185,heavy
14:15,5,Sunday,66,14,21,7,108,normal
14:30,5,Sunday,89,24,12,6,131,normal
14:45,5,Sunday,80,17,16,5,118,normal
15:00,5,Sunday,114,21,10,9,154,normal
15:15,5,Sunday,94,20,7,10,131,normal
15:30,5,Sunday,70,18,28,5,121,high
15:45,5,Sunday,56,17,15,8,96,low
16:00,5,Sunday,141,15,20,6,182,heavy
16:15,5,Sunday,150,19,46,7,222,heavy
16:30,5,Sunday,119,37,22,8,186,heavy
16:45,5,Sunday,144,14,44,5,207,heavy
17:00,5,Sunday,110,25,46,6,187,heavy
17:15,5,Sunday,138,15,31,10,194,heavy
17:30,5,Sunday,140,35,41,5,221,heavy
17:45,5,Sunday,103,24,28,8,163,high
18:00,5,Sunday,142,27,30,5,204,heavy
18:15,5,Sunday,149,13,22,9,193,heavy
18:30,5,Sunday,126,40,39,8,213,heavy
18:45,5,Sunday,78,15,14,28,135,high
19:00,5,Sunday,102,15,11,29,157,high
19:15,5,Sunday,96,22,20,12,150,normal
19:30,5,Sunday,110,24,15,14,163,normal
19:45,5,Sunday,97,22,17,13,149,normal
20:00,5,Sunday,53,19,11,18,101,normal
20:15,5,Sunday,82,8,17,29,136,high
20:30,5,Sunday,91,24,18,29,162,high
20:45,5,Sunday,102,6,14,35,157,high
21:00,5,Sunday,109,6,15,18,148,normal
21:15,5,Sunday,78,16,13,27,134,high
21:30,5,Sunday,66,12,16,33,127,high
21:45,5,Sunday,100,17,15,22,154,high
22:00,5,Sunday,15,1,1,25,42,normal
22:15,5,Sunday,16,1,0,33,50,normal
22:30,5,Sunday,19,4,0,26,49,normal
22:45,5,Sunday,10,0,1,34,45,normal
23:00,5,Sunday,14,0,0,28,42,normal
23:15,5,Sunday,13,2,0,22,37,normal
23:30,5,Sunday,18,5,1,20,44,normal
23:45,5,Sunday,18,4,0,18,40,normal
0:00,6,Monday,11,3,0,26,40,normal
0:15,6,Monday,13,1,0,24,38,normal
0:30,6,Monday,19,5,1,15,40,normal
0:45,6,Monday,11,3,1,28,43,normal
1:00,6,Monday,11,1,1,40,53,normal
1:15,6,Monday,18,4,1,28,51,normal
1:30,6,Monday,15,2,1,16,34,normal
1:45,6,Monday,20,0,0,27,47,normal
2:00,6,Monday,14,5,0,17,36,normal
2:15,6,Monday,11,3,1,10,25,low
2:30,6,Monday,18,5,0,22,45,normal
2:45,6,Monday,12,4,0,16,32,normal
3:00,6,Monday,10,2,0,24,36,normal
3:15,6,Monday,20,0,1,36,57,normal
3:30,6,Monday,20,1,0,29,50,normal
3:45,6,Monday,16,4,0,24,44,normal
4:00,6,Monday,18,3,0,22,43,normal
4:15,6,Monday,88,11,10,3,112,normal
4:30,6,Monday,114,5,9,7,135,normal
4:45,6,Monday,103,3,9,17,132,normal
5:00,6,Monday,81,16,7,14,118,normal
5:15,6,Monday,94,1,9,3,107,low
5:30,6,Monday,56,11,9,15,91,normal
5:45,6,Monday,80,16,5,10,111,low
6:00,6,Monday,138,35,47,4,224,heavy
6:15,6,Monday,123,27,22,4,176,heavy
6:30,6,Monday,114,30,36,2,182,heavy
6:45,6,Monday,122,30,37,2,191,heavy
7:00,6,Monday,148,10,28,2,188,heavy
7:15,6,Monday,127,38,48,0,213,heavy
7:30,6,Monday,113,32,44,1,190,heavy
7:45,6,Monday,131,26,40,1,198,heavy
8:00,6,Monday,108,27,44,5,184,heavy
8:15,6,Monday,109,19,49,3,180,heavy
8:30,6,Monday,125,15,28,3,171,heavy
8:45,6,Monday,139,30,35,4,208,heavy
9:00,6,Monday,103,35,50,2,190,heavy
9:15,6,Monday,64,13,40,12,129,high
9:30,6,Monday,79,1,10,30,120,high
9:45,6,Monday,50,2,7,14,73,normal
10:00,6,Monday,84,18,18,28,148,high
10:15,6,Monday,99,16,39,26,180,heavy
10:30,6,Monday,42,3,27,18,90,normal
10:45,6,Monday,53,2,29,24,108,normal
11:00,6,Monday,63,10,8,28,109,normal
11:15,6,Monday,24,8,3,20,55,normal
11:30,6,Monday,46,8,6,26,86,normal
11:45,6,Monday,20,7,8,26,61,normal
12:00,6,Monday,41,8,7,27,83,normal
12:15,6,Monday,44,5,3,28,80,normal
12:30,6,Monday,33,6,14,28,81,normal
12:45,6,Monday,30,9,7,25,71,normal
13:00,6,Monday,68,7,5,25,105,normal
13:15,6,Monday,28,29,26,5,88,normal
13:30,6,Monday,96,20,14,18,148,normal
13:45,6,Monday,24,15,26,13,78,normal
14:00,6,Monday,70,21,32,18,141,high
14:15,6,Monday,49,21,11,20,101,normal
14:30,6,Monday,51,22,12,16,101,normal
14:45,6,Monday,84,12,15,15,126,normal
15:00,6,Monday,99,18,7,20,144,normal
15:15,6,Monday,106,10,9,8,133,normal
15:30,6,Monday,6,11,34,20,71,normal
15:45,6,Monday,59,29,15,16,119,normal
16:00,6,Monday,139,25,41,5,210,heavy
16:15,6,Monday,109,12,49,6,176,heavy
16:30,6,Monday,124,24,47,9,204,heavy
16:45,6,Monday,135,29,39,7,210,heavy
17:00,6,Monday,137,15,37,7,196,heavy
17:15,6,Monday,119,28,46,9,202,heavy
17:30,6,Monday,127,21,28,5,181,heavy
17:45,6,Monday,109,37,44,9,199,heavy
18:00,6,Monday,145,27,35,7,214,heavy
18:15,6,Monday,133,36,28,6,203,heavy
18:30,6,Monday,138,19,36,5,198,heavy
18:45,6,Monday,73,5,20,10,108,normal
19:00,6,Monday,83,11,14,33,141,high
19:15,6,Monday,89,8,10,19,126,normal
19:30,6,Monday,99,19,18,24,160,high
19:45,6,Monday,54,17,14,8,93,low
20:00,6,Monday,58,18,14,6,96,low
20:15,6,Monday,56,16,12,9,93,low
20:30,6,Monday,77,6,20,5,108,normal
20:45,6,Monday,85,6,18,17,126,normal
21:00,6,Monday,105,14,13,32,164,high
21:15,6,Monday,96,21,11,24,152,high
21:30,6,Monday,66,22,17,16,121,normal
21:45,6,Monday,88,15,19,14,136,normal
22:00,6,Monday,16,1,1,24,42,normal
22:15,6,Monday,13,1,0,11,25,low
22:30,6,Monday,13,5,1,23,42,normal
22:45,6,Monday,19,5,0,37,61,normal
23:00,6,Monday,19,1,0,31,51,normal
23:15,6,Monday,11,5,0,19,35,normal
23:30,6,Monday,18,3,0,32,53,normal
23:45,6,Monday,17,1,1,38,57,normal
0:00,7,Tuesday,17,3,0,20,40,normal
0:15,7,Tuesday,18,4,1,19,42,normal
0:30,7,Tuesday,19,3,0,24,46,normal
0:45,7,Tuesday,16,3,0,15,34,normal
1:00,7,Tuesday,12,5,1,21,39,normal
1:15,7,Tuesday,17,3,0,36,56,normal
1:30,7,Tuesday,19,4,1,21,45,normal
1:45,7,Tuesday,13,5,0,20,38,normal
2:00,7,Tuesday,14,0,1,37,52,normal
2:15,7,Tuesday,14,5,0,39,58,normal
2:30,7,Tuesday,13,1,0,19,33,normal
2:45,7,Tuesday,18,5,1,25,49,normal
3:00,7,Tuesday,15,1,1,15,32,normal
3:15,7,Tuesday,19,2,0,30,51,normal
3:30,7,Tuesday,18,2,1,27,48,normal
3:45,7,Tuesday,13,1,0,38,52,normal
4:00,7,Tuesday,19,2,0,32,53,normal
4:15,7,Tuesday,116,0,1,9,126,normal
4:30,7,Tuesday,60,12,8,15,95,normal
4:45,7,Tuesday,82,15,0,19,116,normal
5:00,7,Tuesday,67,23,7,3,100,low
5:15,7,Tuesday,59,27,10,18,114,normal
5:30,7,Tuesday,66,6,9,5,86,low
5:45,7,Tuesday,120,10,3,16,149,normal
6:00,7,Tuesday,121,22,30,0,173,heavy
6:15,7,Tuesday,130,27,39,5,201,heavy
6:30,7,Tuesday,139,31,44,3,217,heavy
6:45,7,Tuesday,129,14,43,5,191,heavy
7:00,7,Tuesday,131,28,43,5,207,heavy
7:15,7,Tuesday,119,39,24,1,183,heavy
7:30,7,Tuesday,142,25,34,5,206,heavy
7:45,7,Tuesday,123,22,22,3,170,heavy
8:00,7,Tuesday,106,19,38,4,167,normal
8:15,7,Tuesday,115,39,20,2,176,heavy
8:30,7,Tuesday,111,17,32,1,161,high
8:45,7,Tuesday,144,26,50,3,223,normal
9:00,7,Tuesday,126,31,48,2,207,heavy
9:15,7,Tuesday,73,22,21,29,145,high
9:30,7,Tuesday,28,7,25,18,78,normal
9:45,7,Tuesday,31,10,40,9,90,normal
10:00,7,Tuesday,51,14,33,14,112,high
10:15,7,Tuesday,22,7,39,23,91,normal
10:30,7,Tuesday,46,5,11,21,83,normal
10:45,7,Tuesday,72,22,21,27,142,high
11:00,7,Tuesday,70,5,5,29,109,normal
11:15,7,Tuesday,28,9,9,24,70,normal
11:30,7,Tuesday,44,5,11,23,83,normal
11:45,7,Tuesday,27,6,13,30,76,normal
12:00,7,Tuesday,20,6,6,23,55,normal
12:15,7,Tuesday,29,7,3,28,67,normal
12:30,7,Tuesday,20,6,5,27,58,normal
12:45,7,Tuesday,65,9,15,22,111,normal
13:00,7,Tuesday,36,5,6,20,67,normal
13:15,7,Tuesday,99,21,21,6,147,normal
13:30,7,Tuesday,101,21,34,18,174,heavy
13:45,7,Tuesday,98,29,34,12,173,heavy
14:00,7,Tuesday,113,20,7,13,153,normal
14:15,7,Tuesday,75,24,27,7,133,high
14:30,7,Tuesday,71,21,38,11,141,high
14:45,7,Tuesday,119,13,32,7,171,heavy
15:00,7,Tuesday,114,11,39,13,177,heavy
15:15,7,Tuesday,99,26,8,11,144,normal
15:30,7,Tuesday,39,12,21,9,81,normal
15:45,7,Tuesday,114,26,16,20,176,heavy
16:00,7,Tuesday,120,32,39,9,200,heavy
16:15,7,Tuesday,143,24,35,6,208,heavy
16:30,7,Tuesday,121,28,21,5,175,heavy
16:45,7,Tuesday,134,23,28,10,195,heavy
17:00,7,Tuesday,103,13,37,10,163,high
17:15,7,Tuesday,122,12,48,10,192,heavy
17:30,7,Tuesday,145,39,23,6,213,heavy
17:45,7,Tuesday,105,13,48,10,176,heavy
18:00,7,Tuesday,144,13,40,10,207,heavy
18:15,7,Tuesday,103,18,40,5,166,high
18:30,7,Tuesday,120,15,34,8,177,heavy
18:45,7,Tuesday,56,19,16,13,104,normal
19:00,7,Tuesday,56,5,17,14,92,normal
19:15,7,Tuesday,108,15,13,5,141,normal
19:30,7,Tuesday,58,23,14,34,129,high
19:45,7,Tuesday,58,13,11,33,115,high
20:00,7,Tuesday,76,24,14,15,129,normal
20:15,7,Tuesday,69,8,13,28,118,high
20:30,7,Tuesday,54,9,12,10,85,low
20:45,7,Tuesday,89,7,10,10,116,normal
21:00,7,Tuesday,110,18,18,10,156,normal
21:15,7,Tuesday,86,12,17,18,133,normal
21:30,7,Tuesday,82,7,16,9,114,normal
21:45,7,Tuesday,102,5,19,11,137,normal
22:00,7,Tuesday,16,5,0,21,42,normal
22:15,7,Tuesday,11,3,1,39,54,normal
22:30,7,Tuesday,18,5,0,11,34,low
22:45,7,Tuesday,12,0,1,32,45,normal
23:00,7,Tuesday,15,4,1,39,59,normal
23:15,7,Tuesday,15,4,0,26,45,normal
23:30,7,Tuesday,13,1,0,30,44,normal
23:45,7,Tuesday,12,3,0,28,43,normal
0:00,8,Wednesday,17,2,1,20,40,normal
0:15,8,Wednesday,14,5,1,33,53,normal
0:30,8,Wednesday,16,3,1,11,31,low
0:45,8,Wednesday,18,2,1,13,34,normal
1:00,8,Wednesday,12,2,1,17,32,normal
1:15,8,Wednesday,17,4,1,15,37,normal
1:30,8,Wednesday,18,1,1,25,45,normal
1:45,8,Wednesday,20,1,1,10,32,low
2:00,8,Wednesday,15,1,0,21,37,normal
2:15,8,Wednesday,11,3,1,34,49,normal
2:30,8,Wednesday,19,0,1,13,33,normal
2:45,8,Wednesday,10,3,0,14,27,normal
3:00,8,Wednesday,17,5,1,17,40,normal
3:15,8,Wednesday,16,1,0,11,28,low
3:30,8,Wednesday,11,0,1,33,45,normal
3:45,8,Wednesday,10,5,0,39,54,normal
4:00,8,Wednesday,12,3,0,32,47,normal
4:15,8,Wednesday,106,16,10,10,142,normal
4:30,8,Wednesday,69,18,0,12,99,low
4:45,8,Wednesday,103,26,6,12,147,normal
5:00,8,Wednesday,99,25,6,6,136,normal
5:15,8,Wednesday,85,9,4,11,109,low
5:30,8,Wednesday,109,0,3,8,120,normal
5:45,8,Wednesday,106,27,1,6,140,normal
6:00,8,Wednesday,133,28,31,3,195,heavy
6:15,8,Wednesday,108,39,34,5,186,heavy
6:30,8,Wednesday,101,12,48,1,162,high
6:45,8,Wednesday,145,11,29,1,186,heavy
7:00,8,Wednesday,112,33,29,3,177,heavy
7:15,8,Wednesday,111,18,32,4,165,high
7:30,8,Wednesday,133,39,44,2,218,heavy
7:45,8,Wednesday,115,34,37,5,191,heavy
8:00,8,Wednesday,135,35,38,3,211,heavy
8:15,8,Wednesday,142,40,28,3,213,heavy
8:30,8,Wednesday,124,11,27,2,164,high
8:45,8,Wednesday,122,29,31,5,187,heavy
9:00,8,Wednesday,101,19,23,5,148,normal
9:15,8,Wednesday,72,5,15,20,112,normal
9:30,8,Wednesday,100,13,23,9,145,normal
9:45,8,Wednesday,32,10,33,8,83,normal
10:00,8,Wednesday,42,25,37,12,116,high
10:15,8,Wednesday,81,25,40,20,166,high
10:30,8,Wednesday,56,18,9,23,106,normal
10:45,8,Wednesday,84,9,31,17,141,high
11:00,8,Wednesday,36,9,8,28,81,normal
11:15,8,Wednesday,32,5,11,27,75,normal
11:30,8,Wednesday,26,7,15,27,75,normal
11:45,8,Wednesday,34,5,5,22,66,normal
12:00,8,Wednesday,66,9,6,30,111,normal
12:15,8,Wednesday,69,10,4,24,107,normal
12:30,8,Wednesday,44,7,9,20,80,normal
12:45,8,Wednesday,58,10,5,27,100,normal
13:00,8,Wednesday,27,6,14,30,77,normal
13:15,8,Wednesday,19,21,25,15,80,normal
13:30,8,Wednesday,39,15,30,8,92,normal
13:45,8,Wednesday,109,21,10,12,152,normal
14:00,8,Wednesday,93,10,9,15,127,normal
14:15,8,Wednesday,73,16,12,11,112,normal
14:30,8,Wednesday,111,18,29,16,174,heavy
14:45,8,Wednesday,37,20,10,19,86,normal
15:00,8,Wednesday,74,23,13,20,130,normal
15:15,8,Wednesday,32,28,35,6,101,normal
15:30,8,Wednesday,34,23,19,17,93,normal
15:45,8,Wednesday,59,25,9,20,113,normal
16:00,8,Wednesday,145,12,24,8,189,heavy
16:15,8,Wednesday,118,17,28,8,171,heavy
16:30,8,Wednesday,145,20,47,8,220,heavy
16:45,8,Wednesday,140,25,46,10,221,heavy
17:00,8,Wednesday,120,35,43,7,205,heavy
17:15,8,Wednesday,126,24,31,7,188,heavy
17:30,8,Wednesday,106,22,43,5,176,heavy
17:45,8,Wednesday,137,40,28,9,214,heavy
18:00,8,Wednesday,108,40,25,6,179,heavy
18:15,8,Wednesday,135,15,50,6,206,heavy
18:30,8,Wednesday,121,21,49,8,199,heavy
18:45,8,Wednesday,59,6,20,6,91,normal
19:00,8,Wednesday,59,13,18,27,117,high
19:15,8,Wednesday,103,7,15,15,140,normal
19:30,8,Wednesday,56,14,14,31,115,high
19:45,8,Wednesday,106,23,12,9,150,normal
20:00,8,Wednesday,109,5,16,17,147,normal
20:15,8,Wednesday,110,5,20,11,146,normal
20:30,8,Wednesday,86,15,15,23,139,high
20:45,8,Wednesday,91,18,19,26,154,high
21:00,8,Wednesday,99,19,15,28,161,high
21:15,8,Wednesday,93,14,20,17,144,normal
21:30,8,Wednesday,89,25,13,23,150,high
21:45,8,Wednesday,107,15,12,24,158,high
22:00,8,Wednesday,16,5,0,14,35,normal
22:15,8,Wednesday,14,5,1,20,40,normal
22:30,8,Wednesday,18,3,0,24,45,normal
22:45,8,Wednesday,12,3,0,40,55,normal
23:00,8,Wednesday,14,4,1,27,46,normal
23:15,8,Wednesday,18,5,1,15,39,normal
23:30,8,Wednesday,10,4,1,23,38,normal
23:45,8,Wednesday,10,5,0,14,29,normal
0:00,9,Thursday,14,3,0,28,45,normal
0:15,9,Thursday,10,2,0,38,50,normal
0:30,9,Thursday,19,0,0,32,51,normal
0:45,9,Thursday,20,3,0,19,42,normal
1:00,9,Thursday,18,3,0,14,35,normal
1:15,9,Thursday,11,2,0,12,25,low
1:30,9,Thursday,17,1,1,13,32,normal
1:45,9,Thursday,10,0,1,36,47,normal
2:00,9,Thursday,17,0,0,32,49,normal
2:15,9,Thursday,20,5,1,22,48,normal
2:30,9,Thursday,12,3,0,17,32,normal
2:45,9,Thursday,13,0,0,31,44,normal
3:00,9,Thursday,11,1,1,35,48,normal
3:15,9,Thursday,18,2,0,19,39,normal
3:30,9,Thursday,15,0,1,24,40,normal
3:45,9,Thursday,14,3,0,25,42,normal
4:00,9,Thursday,12,0,1,16,29,normal
4:15,9,Thursday,85,24,5,5,119,normal
4:30,9,Thursday,71,22,5,2,100,low
4:45,9,Thursday,108,4,5,3,120,normal
5:00,9,Thursday,63,29,5,15,112,normal
5:15,9,Thursday,62,12,3,18,95,normal
5:30,9,Thursday,118,15,3,11,147,normal
5:45,9,Thursday,90,21,2,14,127,normal
6:00,9,Thursday,141,30,31,1,203,heavy
6:15,9,Thursday,126,31,33,2,192,heavy
6:30,9,Thursday,112,26,30,4,172,heavy
6:45,9,Thursday,112,12,38,4,166,high
7:00,9,Thursday,144,14,33,4,195,heavy
7:15,9,Thursday,127,13,36,1,177,heavy
7:30,9,Thursday,146,10,44,5,205,heavy
7:45,9,Thursday,146,22,26,4,198,heavy
8:00,9,Thursday,101,10,48,5,164,high
8:15,9,Thursday,104,19,24,4,151,normal
8:30,9,Thursday,150,20,43,0,213,heavy
8:45,9,Thursday,110,35,45,2,192,heavy
9:00,9,Thursday,139,15,28,2,184,heavy
9:15,9,Thursday,99,17,32,7,155,high
9:30,9,Thursday,22,15,7,19,63,normal
9:45,9,Thursday,11,12,21,24,68,normal
10:00,9,Thursday,47,20,18,16,101,normal
10:15,9,Thursday,54,1,35,26,116,high
10:30,9,Thursday,26,16,13,16,71,normal
10:45,9,Thursday,99,18,39,19,175,heavy
11:00,9,Thursday,31,9,11,28,79,normal
11:15,9,Thursday,24,8,13,23,68,normal
11:30,9,Thursday,21,7,9,20,57,normal
11:45,9,Thursday,60,10,5,25,100,normal
12:00,9,Thursday,29,9,12,21,71,normal
12:15,9,Thursday,37,7,14,28,86,normal
12:30,9,Thursday,53,7,11,22,93,normal
12:45,9,Thursday,35,5,15,25,80,normal
13:00,9,Thursday,53,6,10,28,97,normal
13:15,9,Thursday,114,18,17,8,157,normal
13:30,9,Thursday,95,28,22,9,154,normal
13:45,9,Thursday,62,23,38,19,142,high
14:00,9,Thursday,70,28,12,12,122,normal
14:15,9,Thursday,35,20,10,8,73,low
14:30,9,Thursday,60,23,10,20,113,normal
14:45,9,Thursday,40,22,25,9,96,normal
15:00,9,Thursday,53,21,6,11,91,low
15:15,9,Thursday,99,16,38,7,160,high
15:30,9,Thursday,86,21,31,18,156,high
15:45,9,Thursday,79,28,35,13,155,high
16:00,9,Thursday,146,25,33,8,212,heavy
16:15,9,Thursday,116,24,36,6,182,heavy
16:30,9,Thursday,107,14,44,5,170,heavy
16:45,9,Thursday,115,20,27,9,171,heavy
17:00,9,Thursday,113,23,43,6,185,heavy
17:15,9,Thursday,102,20,31,5,158,high
17:30,9,Thursday,138,27,21,7,193,heavy
17:45,9,Thursday,146,13,38,9,206,heavy
18:00,9,Thursday,139,33,41,7,220,heavy
18:15,9,Thursday,130,24,48,9,211,heavy
18:30,9,Thursday,135,31,34,8,208,heavy
18:45,9,Thursday,106,22,16,20,164,normal
19:00,9,Thursday,109,23,14,26,172,heavy
19:15,9,Thursday,108,24,19,10,161,normal
19:30,9,Thursday,50,16,16,11,93,normal
19:45,9,Thursday,102,22,17,10,151,normal
20:00,9,Thursday,72,25,10,27,134,high
20:15,9,Thursday,91,13,18,13,135,normal
20:30,9,Thursday,67,19,11,8,105,low
20:45,9,Thursday,61,14,10,5,90,low
21:00,9,Thursday,107,13,14,28,162,high
21:15,9,Thursday,91,5,12,34,142,high
21:30,9,Thursday,106,18,13,27,164,high
21:45,9,Thursday,107,14,10,18,149,normal
22:00,9,Thursday,17,4,1,20,42,normal
22:15,9,Thursday,11,4,1,30,46,normal
22:30,9,Thursday,11,4,0,23,38,normal
22:45,9,Thursday,16,3,1,36,56,normal
23:00,9,Thursday,11,0,1,30,42,normal
23:15,9,Thursday,15,4,1,25,45,normal
23:30,9,Thursday,16,5,0,27,48,normal
23:45,9,Thursday,14,3,1,15,33,normal