,Time,Date,Day of the week,CarCount,BikeCount,BusCount,TruckCount,Total,Traffic Situation
0,0,10,Tuesday,31,0,4,4,39,low
1,0,10,Tuesday,49,0,3,3,55,low
2,0,10,Tuesday,46,0,3,6,55,low
3,0,10,Tuesday,51,0,2,5,58,low
4,0,10,Tuesday,57,6,15,16,94,normal
5,0,10,Tuesday,44,0,5,4,53,low
6,0,10,Tuesday,37,0,1,4,42,low
7,0,10,Tuesday,42,4,4,5,55,low
8,0,10,Tuesday,51,0,9,7,67,low
9,0,10,Tuesday,34,0,4,7,45,low
10,0,10,Tuesday,45,0,1,1,47,low
11,0,10,Tuesday,45,0,1,3,49,low
12,0,10,Tuesday,50,0,3,0,53,low
13,0,10,Tuesday,34,0,4,4,42,low
14,0,10,Tuesday,129,22,42,1,194,heavy
15,0,10,Tuesday,144,16,49,0,209,heavy
16,0,10,Tuesday,111,28,20,3,162,normal
17,0,10,Tuesday,67,11,10,16,104,normal
18,0,10,Tuesday,65,24,7,16,112,normal
19,0,10,Tuesday,94,27,7,16,144,normal
20,0,10,Tuesday,94,20,8,7,129,normal
21,0,10,Tuesday,67,29,5,10,111,low
22,0,10,Tuesday,56,12,2,14,84,normal
23,0,10,Tuesday,57,13,3,11,84,low
24,0,10,Tuesday,129,22,42,1,194,heavy
25,0,10,Tuesday,144,16,49,0,209,heavy
26,0,10,Tuesday,111,28,20,3,162,normal
27,0,10,Tuesday,120,27,46,3,196,heavy
28,0,10,Tuesday,102,39,47,1,189,heavy
29,0,10,Tuesday,145,23,27,0,195,heavy
30,0,10,Tuesday,114,37,21,5,177,heavy
31,0,10,Tuesday,108,18,22,1,149,normal
32,0,10,Tuesday,122,28,33,1,184,heavy
33,0,10,Tuesday,114,39,30,3,186,heavy
34,0,10,Tuesday,150,36,25,1,212,heavy
35,0,10,Tuesday,107,10,49,2,168,heavy
36,0,10,Tuesday,124,24,22,0,170,heavy
37,0,10,Tuesday,77,16,39,29,161,high
38,0,10,Tuesday,15,23,30,21,89,normal
39,0,10,Tuesday,32,22,38,21,113,high
40,0,10,Tuesday,68,13,29,24,134,high
41,0,10,Tuesday,27,16,36,30,109,normal
42,0,10,Tuesday,76,7,11,15,109,normal
43,0,10,Tuesday,41,23,20,17,101,normal
44,0,10,Tuesday,33,10,3,29,75,normal
45,0,10,Tuesday,58,8,14,29,109,normal
46,0,10,Tuesday,65,7,11,26,109,normal
47,0,10,Tuesday,47,9,6,29,91,normal
48,0,10,Tuesday,38,10,5,25,78,normal
49,0,10,Tuesday,57,8,12,29,106,normal
50,0,10,Tuesday,20,6,4,20,50,normal
51,0,10,Tuesday,24,9,14,23,70,normal
52,0,10,Tuesday,52,10,13,21,96,normal
53,0,10,Tuesday,79,15,36,18,148,high
54,0,10,Tuesday,84,24,22,18,148,normal
55,0,10,Tuesday,59,19,35,16,129,high
56,0,10,Tuesday,88,26,31,19,164,high
57,0,10,Tuesday,24,11,32,13,80,normal
58,0,10,Tuesday,110,17,23,20,170,heavy
59,0,10,Tuesday,29,26,5,6,66,low
60,0,10,Tuesday,43,26,11,20,100,normal
61,0,10,Tuesday,68,28,9,15,120,normal
62,0,10,Tuesday,108,16,8,18,150,normal
63,0,10,Tuesday,101,26,8,14,149,normal
64,0,10,Tuesday,141,31,36,6,214,heavy
65,0,10,Tuesday,120,25,28,5,178,heavy
66,0,10,Tuesday,137,23,44,5,209,heavy
67,0,10,Tuesday,124,11,30,7,172,heavy
68,0,10,Tuesday,145,25,49,7,226,heavy
69,0,10,Tuesday,122,37,23,8,190,heavy
70,0,10,Tuesday,136,30,20,9,195,heavy
71,0,10,Tuesday,145,18,40,9,212,heavy
72,0,10,Tuesday,138,34,28,5,205,heavy
73,0,10,Tuesday,123,10,29,8,170,heavy
74,0,10,Tuesday,105,15,21,9,150,normal
75,0,10,Tuesday,75,22,20,11,128,normal
76,0,10,Tuesday,90,12,10,13,125,normal
77,0,10,Tuesday,102,22,20,16,160,normal
78,0,10,Tuesday,61,18,15,27,121,high
79,0,10,Tuesday,70,8,14,6,98,low
80,0,10,Tuesday,80,17,12,34,143,high
81,0,10,Tuesday,62,12,14,19,107,normal
82,0,10,Tuesday,96,5,11,13,125,normal
83,0,10,Tuesday,102,6,12,13,133,normal
84,0,10,Tuesday,91,14,15,6,126,normal
85,0,10,Tuesday,95,8,17,13,133,normal
86,0,10,Tuesday,75,15,12,21,123,high
87,0,10,Tuesday,53,21,20,10,104,normal
88,0,10,Tuesday,13,1,0,19,33,normal
89,0,10,Tuesday,10,0,1,24,35,normal
90,0,10,Tuesday,16,2,0,33,51,normal
91,0,10,Tuesday,11,1,0,29,41,normal
92,0,10,Tuesday,18,2,1,13,34,normal
93,0,10,Tuesday,15,0,1,11,27,low
94,0,10,Tuesday,14,1,0,33,48,normal
95,0,10,Tuesday,17,2,0,22,41,normal
96,0,11,Wednesday,12,2,1,17,32,normal
97,0,11,Wednesday,18,0,0,29,47,normal
98,0,11,Wednesday,16,1,0,14,31,normal
99,0,11,Wednesday,20,0,0,14,34,normal
100,0,11,Wednesday,20,1,1,30,52,normal
101,0,11,Wednesday,15,0,1,23,39,normal
102,0,11,Wednesday,16,0,1,26,43,normal
103,0,11,Wednesday,18,4,0,11,33,low
104,0,11,Wednesday,17,3,1,36,57,normal
105,0,11,Wednesday,14,4,1,10,29,low
106,0,11,Wednesday,18,2,1,25,46,normal
107,0,11,Wednesday,12,2,0,19,33,normal
108,0,11,Wednesday,11,4,0,30,45,normal
109,0,11,Wednesday,19,1,1,36,57,normal
110,0,11,Wednesday,10,4,0,36,50,normal
111,0,11,Wednesday,20,1,1,32,54,normal
112,0,11,Wednesday,15,5,1,40,61,normal
113,0,11,Wednesday,104,6,5,1,116,normal
114,0,11,Wednesday,109,25,3,8,145,normal
115,0,11,Wednesday,82,23,8,20,133,normal
116,0,11,Wednesday,81,25,1,18,125,normal
117,0,11,Wednesday,95,16,10,1,122,normal
118,0,11,Wednesday,91,24,7,6,128,normal
119,0,11,Wednesday,81,30,10,0,121,normal
120,0,11,Wednesday,125,13,26,2,166,high
121,0,11,Wednesday,125,39,49,3,216,heavy
122,0,11,Wednesday,125,34,37,1,197,heavy
123,0,11,Wednesday,125,19,25,4,173,heavy
124,0,11,Wednesday,125,15,49,0,189,heavy
125,0,11,Wednesday,125,32,50,5,212,heavy
126,0,11,Wednesday,125,38,50,1,214,heavy
127,0,11,Wednesday,125,29,29,3,186,heavy
128,0,11,Wednesday,125,31,48,4,208,heavy
129,0,11,Wednesday,125,32,50,0,207,heavy
130,0,11,Wednesday,125,31,45,0,201,heavy
131,0,11,Wednesday,125,21,20,1,167,normal
132,0,11,Wednesday,125,28,36,0,189,heavy
133,0,11,Wednesday,39,10,37,16,102,normal
134,0,11,Wednesday,89,8,12,13,122,normal
135,0,11,Wednesday,51,16,16,13,96,normal
136,0,11,Wednesday,17,9,18,28,72,normal
137,0,11,Wednesday,48,25,36,21,130,high
138,0,11,Wednesday,93,7,30,16,146,high
139,0,11,Wednesday,55,15,36,15,121,high
140,0,11,Wednesday,51,10,8,22,91,normal
141,0,11,Wednesday,51,7,3,24,85,normal
142,0,11,Wednesday,51,9,7,30,97,normal
143,0,11,Wednesday,51,7,14,20,92,normal
144,0,11,Wednesday,51,10,14,20,95,normal
145,0,11,Wednesday,51,10,6,22,89,normal
146,0,11,Wednesday,51,8,11,22,92,normal
147,0,11,Wednesday,51,6,10,26,93,normal
148,0,11,Wednesday,51,7,7,27,92,normal
149,0,11,Wednesday,104,17,25,20,166,normal
150,0,11,Wednesday,6,28,27,14,75,normal
151,0,11,Wednesday,54,29,37,9,129,high
152,0,11,Wednesday,43,13,30,20,106,normal
153,0,11,Wednesday,60,21,26,11,118,high
154,0,11,Wednesday,101,23,8,20,152,normal
155,0,11,Wednesday,62,26,19,11,118,normal
156,0,11,Wednesday,39,24,13,11,87,low
157,0,11,Wednesday,90,20,35,7,152,high
158,0,11,Wednesday,109,30,22,20,181,heavy
159,0,11,Wednesday,68,26,25,20,139,normal
160,0,11,Wednesday,142,22,37,6,207,heavy
161,0,11,Wednesday,113,14,20,5,152,normal
162,0,11,Wednesday,142,13,37,8,200,heavy
163,0,11,Wednesday,108,23,26,9,166,high
164,0,11,Wednesday,122,29,30,7,188,heavy
165,0,11,Wednesday,133,12,30,7,182,heavy
166,0,11,Wednesday,118,23,38,10,189,heavy
167,0,11,Wednesday,121,35,26,8,190,heavy
168,0,11,Wednesday,116,23,20,8,167,normal
169,0,11,Wednesday,132,12,27,8,179,heavy
170,0,11,Wednesday,144,17,33,7,201,heavy
171,0,11,Wednesday,103,21,11,11,146,normal
172,0,11,Wednesday,107,15,10,15,147,normal
173,0,11,Wednesday,50,10,10,17,87,normal
174,0,11,Wednesday,108,15,10,6,139,normal
175,0,11,Wednesday,108,24,15,29,176,heavy
176,0,11,Wednesday,101,6,15,13,135,normal
177,0,11,Wednesday,55,17,12,19,103,normal
178,0,11,Wednesday,77,7,20,16,120,normal
179,0,11,Wednesday,91,12,19,8,130,normal
180,0,11,Wednesday,95,25,17,29,166,high
181,0,11,Wednesday,78,17,17,27,139,high
182,0,11,Wednesday,98,16,16,21,151,high
183,0,11,Wednesday,86,13,11,35,145,high
184,0,11,Wednesday,18,4,0,16,38,normal
185,0,11,Wednesday,18,5,0,12,35,low
186,0,11,Wednesday,18,2,1,25,46,normal
187,0,11,Wednesday,18,1,0,17,36,normal
188,0,11,Wednesday,18,5,0,21,44,normal
189,0,11,Wednesday,18,0,1,12,31,low
190,0,11,Wednesday,18,3,1,28,50,normal
191,0,11,Wednesday,18,4,1,40,63,normal
192,0,12,Thursday,18,1,1,39,59,normal
193,0,12,Thursday,18,4,0,30,52,normal
194,0,12,Thursday,18,5,1,13,37,normal
195,0,12,Thursday,18,2,0,37,57,normal
196,0,12,Thursday,18,0,0,13,31,normal
197,0,12,Thursday,18,5,0,11,34,low
198,0,12,Thursday,18,5,1,12,36,low
199,0,12,Thursday,18,1,1,16,36,normal
200,0,12,Thursday,18,1,1,34,54,normal
201,0,12,Thursday,18,1,0,24,43,normal
202,0,12,Thursday,18,0,0,23,41,normal
203,0,12,Thursday,18,0,0,27,45,normal
204,0,12,Thursday,18,5,0,28,51,normal
205,0,12,Thursday,18,1,0,14,33,normal
206,0,12,Thursday,18,5,0,25,48,normal
207,0,12,Thursday,18,4,1,30,53,normal
208,0,12,Thursday,18,5,1,30,54,normal
209,0,12,Thursday,62,24,7,2,95,low
210,0,12,Thursday,51,23,6,1,81,low
211,0,12,Thursday,114,23,10,19,166,normal
212,0,12,Thursday,85,22,9,9,125,normal
213,0,12,Thursday,102,24,4,20,150,normal
214,0,12,Thursday,101,18,3,17,139,normal
215,0,12,Thursday,116,19,0,17,152,normal
216,0,12,Thursday,117,38,50,5,210,heavy
217,0,12,Thursday,114,32,34,2,182,heavy
218,0,12,Thursday,120,17,23,1,161,normal
219,0,12,Thursday,145,20,25,2,192,heavy
220,0,12,Thursday,125,30,48,1,204,heavy
221,0,12,Thursday,103,27,45,1,176,heavy
222,0,12,Thursday,114,20,43,1,178,heavy
223,0,12,Thursday,145,10,44,1,200,heavy
224,0,12,Thursday,147,31,20,4,202,heavy
225,0,12,Thursday,104,24,40,0,168,heavy
226,0,12,Thursday,124,11,22,0,157,normal
227,0,12,Thursday,101,37,31,4,173,heavy
228,0,12,Thursday,144,30,37,1,212,heavy
229,0,12,Thursday,24,18,37,18,97,normal
230,0,12,Thursday,24,8,17,25,74,normal
231,0,12,Thursday,16,22,12,20,70,normal
232,0,12,Thursday,26,2,39,26,93,normal
233,0,12,Thursday,90,7,18,15,130,normal
234,0,12,Thursday,59,6,11,11,87,low
235,0,12,Thursday,28,7,22,18,75,normal
236,0,12,Thursday,60,5,14,21,100,normal
237,0,12,Thursday,69,9,8,23,109,normal
238,0,12,Thursday,59,9,12,26,106,normal
239,0,12,Thursday,24,10,5,21,60,normal
240,0,12,Thursday,41,7,7,21,76,normal
241,0,12,Thursday,48,10,9,29,96,normal
242,0,12,Thursday,59,10,14,23,106,normal
243,0,12,Thursday,67,7,12,28,114,high
244,0,12,Thursday,52,9,8,20,89,normal
245,0,12,Thursday,45,26,29,10,110,normal
246,0,12,Thursday,14,21,7,18,60,normal
247,0,12,Thursday,55,22,24,10,111,normal
248,0,12,Thursday,45,14,39,5,103,normal
249,0,12,Thursday,90,17,16,11,134,normal
250,0,12,Thursday,33,21,25,5,84,normal
251,0,12,Thursday,118,25,31,13,187,heavy
252,0,12,Thursday,86,28,13,5,132,normal
253,0,12,Thursday,105,29,22,12,168,heavy
254,0,12,Thursday,10,19,26,8,63,normal
255,0,12,Thursday,46,22,18,9,95,normal
256,0,12,Thursday,105,35,48,6,194,heavy
257,0,12,Thursday,135,37,34,5,211,heavy
258,0,12,Thursday,103,29,44,6,182,heavy
259,0,12,Thursday,113,13,42,10,178,heavy
260,0,12,Thursday,103,20,27,9,159,high
261,0,12,Thursday,150,13,20,9,192,heavy
262,0,12,Thursday,116,25,33,8,182,heavy
263,0,12,Thursday,109,16,41,9,175,heavy
264,0,12,Thursday,112,11,50,5,178,heavy
265,0,12,Thursday,104,31,30,5,170,heavy
266,0,12,Thursday,146,18,40,6,210,heavy
267,0,12,Thursday,110,24,10,29,173,heavy
268,0,12,Thursday,60,15,12,25,112,high
269,0,12,Thursday,103,9,14,29,155,high
270,0,12,Thursday,102,6,15,6,129,normal
271,0,12,Thursday,51,17,16,8,92,normal
272,0,12,Thursday,62,12,11,18,103,normal
273,0,12,Thursday,103,14,12,5,134,normal
274,0,12,Thursday,50,7,11,23,91,normal
275,0,12,Thursday,80,14,20,6,120,normal
276,0,12,Thursday,98,13,18,21,150,high
277,0,12,Thursday,53,25,20,13,111,normal
278,0,12,Thursday,52,8,10,27,97,normal
279,0,12,Thursday,71,23,13,21,128,high
280,0,12,Thursday,17,3,0,29,49,normal
281,0,12,Thursday,20,5,1,36,62,normal
282,0,12,Thursday,15,0,0,32,47,normal
283,0,12,Thursday,15,0,1,20,36,normal
284,0,12,Thursday,14,2,0,23,39,normal
285,0,12,Thursday,13,1,0,29,43,normal
286,0,12,Thursday,14,5,0,31,50,normal
287,0,12,Thursday,16,3,0,33,52,normal
288,0,13,Friday,18,4,1,15,38,normal
289,0,13,Friday,20,0,1,23,44,normal
290,0,13,Friday,19,3,0,16,38,normal
291,0,13,Friday,10,3,0,12,25,low
292,0,13,Friday,10,4,0,23,37,normal
293,0,13,Friday,12,5,0,29,46,normal
294,0,13,Friday,10,0,0,39,49,normal
295,0,13,Friday,16,2,1,21,40,normal
296,0,13,Friday,18,4,1,36,59,normal
297,0,13,Friday,15,1,0,14,30,normal
298,0,13,Friday,17,4,0,13,34,normal
299,0,13,Friday,18,3,1,24,46,normal
300,0,13,Friday,19,2,0,11,32,low
301,0,13,Friday,19,3,0,21,43,normal
302,0,13,Friday,19,3,1,31,54,normal
303,0,13,Friday,14,2,1,19,36,normal
304,0,13,Friday,11,0,0,27,38,normal
305,0,13,Friday,27,6,1,11,45,low
306,0,13,Friday,33,11,6,13,63,normal
307,0,13,Friday,63,6,7,10,86,low
308,0,13,Friday,58,13,4,15,90,normal
309,0,13,Friday,57,11,7,10,85,low
310,0,13,Friday,63,10,6,12,91,low
311,0,13,Friday,74,9,0,15,98,normal
312,0,13,Friday,71,9,7,10,97,low
313,0,13,Friday,33,9,6,13,61,normal
314,0,13,Friday,29,6,1,12,48,low
315,0,13,Friday,32,9,3,11,55,low
316,0,13,Friday,57,14,3,11,85,low
317,0,13,Friday,31,11,0,14,56,normal
318,0,13,Friday,30,9,3,10,52,low
319,0,13,Friday,61,8,7,12,88,low
320,0,13,Friday,47,10,4,10,71,low
321,0,13,Friday,80,16,4,15,115,normal
322,0,13,Friday,49,10,2,10,71,low
323,0,13,Friday,58,7,5,13,83,normal
324,0,13,Friday,53,19,1,10,83,low
325,0,13,Friday,132,47,25,0,204,heavy
326,0,13,Friday,131,52,15,0,198,heavy
327,0,13,Friday,171,59,27,3,260,heavy
328,0,13,Friday,131,43,20,3,197,heavy
329,0,13,Friday,177,56,12,4,249,heavy
330,0,13,Friday,160,47,30,3,240,heavy
331,0,13,Friday,178,68,28,4,278,heavy
332,0,13,Friday,169,70,20,3,262,heavy
333,0,13,Friday,133,56,25,2,216,heavy
334,0,13,Friday,151,52,13,0,216,heavy
335,0,13,Friday,179,46,27,3,255,heavy
336,0,13,Friday,144,68,20,0,232,heavy
337,0,13,Friday,162,46,19,2,229,heavy
338,0,13,Friday,159,44,23,2,228,heavy
339,0,13,Friday,174,67,30,1,272,heavy
340,0,13,Friday,136,57,29,4,226,heavy
341,0,13,Friday,156,42,12,3,213,heavy
342,0,13,Friday,175,63,19,3,260,heavy
343,0,13,Friday,172,62,20,2,256,heavy
344,0,13,Friday,171,49,15,0,235,heavy
345,0,13,Friday,172,65,18,2,257,heavy
346,0,13,Friday,176,50,13,1,240,heavy
347,0,13,Friday,153,50,23,3,229,heavy
348,0,13,Friday,148,64,27,0,239,heavy
349,0,13,Friday,56,28,6,2,92,low
350,0,13,Friday,88,26,25,0,139,normal
351,0,13,Friday,82,23,14,0,119,normal
352,0,13,Friday,77,20,7,0,104,low
353,0,13,Friday,66,24,1,0,91,low
354,0,13,Friday,72,22,8,2,104,low
355,0,13,Friday,62,28,21,2,113,normal
356,0,13,Friday,66,26,4,1,97,low
357,0,13,Friday,85,20,4,0,109,low
358,0,13,Friday,87,24,11,2,124,normal
359,0,13,Friday,67,28,25,0,120,normal
360,0,13,Friday,70,26,16,2,114,normal
361,0,13,Friday,62,20,20,1,103,normal
362,0,13,Friday,67,29,1,0,97,low
363,0,13,Friday,65,25,1,1,92,low
364,0,13,Friday,76,24,23,0,123,normal
365,0,13,Friday,42,1,5,11,59,low
366,0,13,Friday,42,10,3,1,56,low
367,0,13,Friday,31,11,1,12,55,low
368,0,13,Friday,47,7,3,6,63,low
369,0,13,Friday,28,7,2,4,41,low
370,0,13,Friday,22,3,6,1,32,low
371,0,13,Friday,29,1,7,5,42,low
372,0,13,Friday,43,9,1,11,64,low
373,0,13,Friday,23,3,3,8,37,low
374,0,13,Friday,21,2,5,15,43,normal
375,0,13,Friday,31,2,1,9,43,low
376,0,13,Friday,15,5,0,18,38,normal
377,0,13,Friday,11,2,0,15,28,normal
378,0,13,Friday,12,0,1,17,30,normal
379,0,13,Friday,18,3,0,18,39,normal
380,0,13,Friday,19,1,0,31,51,normal
381,0,13,Friday,17,0,0,22,39,normal
382,0,13,Friday,15,5,0,14,34,normal
383,0,13,Friday,15,1,1,24,41,normal
384,0,14,Saturday,18,4,0,33,55,normal
385,0,14,Saturday,14,4,0,34,52,normal
386,0,14,Saturday,14,0,1,19,34,normal
387,0,14,Saturday,19,3,0,36,58,normal
388,0,14,Saturday,10,4,1,21,36,normal
389,0,14,Saturday,19,1,0,19,39,normal
390,0,14,Saturday,18,5,0,26,49,normal
391,0,14,Saturday,17,1,1,25,44,normal
392,0,14,Saturday,20,2,0,12,34,low
393,0,14,Saturday,15,5,0,15,35,normal
394,0,14,Saturday,11,4,0,14,29,normal
395,0,14,Saturday,14,3,1,18,36,normal
396,0,14,Saturday,13,2,0,39,54,normal
397,0,14,Saturday,17,5,0,29,51,normal
398,0,14,Saturday,13,5,0,31,49,normal
399,0,14,Saturday,18,5,0,35,58,normal
400,0,14,Saturday,15,4,0,16,35,normal
401,0,14,Saturday,55,15,5,3,78,low
402,0,14,Saturday,76,10,7,9,102,low
403,0,14,Saturday,98,0,9,19,126,normal
404,0,14,Saturday,98,12,6,6,122,normal
405,0,14,Saturday,103,2,10,20,135,normal
406,0,14,Saturday,93,17,8,12,130,normal
407,0,14,Saturday,115,27,9,16,167,normal
408,0,14,Saturday,120,12,22,3,157,normal
409,0,14,Saturday,142,18,27,0,187,heavy
410,0,14,Saturday,117,29,49,2,197,heavy
411,0,14,Saturday,126,36,24,0,186,heavy
412,0,14,Saturday,110,39,38,5,192,heavy
413,0,14,Saturday,149,20,39,5,213,heavy
414,0,14,Saturday,109,29,23,5,166,normal
415,0,14,Saturday,124,34,24,4,186,heavy
416,0,14,Saturday,149,35,32,1,217,heavy
417,0,14,Saturday,125,32,38,4,199,heavy
418,0,14,Saturday,101,23,38,1,163,high
419,0,14,Saturday,137,36,30,0,203,heavy
420,0,14,Saturday,139,15,21,3,178,heavy
421,0,14,Saturday,19,3,29,9,60,normal
422,0,14,Saturday,13,11,39,7,70,normal
423,0,14,Saturday,31,2,29,27,89,normal
424,0,14,Saturday,18,24,21,22,85,normal
425,0,14,Saturday,26,12,14,13,65,normal
426,0,14,Saturday,31,15,13,28,87,normal
427,0,14,Saturday,12,22,8,11,53,low
428,0,14,Saturday,54,5,13,23,95,normal
429,0,14,Saturday,59,7,13,21,100,normal
430,0,14,Saturday,58,8,6,23,95,normal
431,0,14,Saturday,53,8,9,25,95,normal
432,0,14,Saturday,54,7,7,20,88,normal
433,0,14,Saturday,39,10,4,29,82,normal
434,0,14,Saturday,38,9,8,22,77,normal
435,0,14,Saturday,36,5,10,23,74,normal
436,0,14,Saturday,68,6,12,24,110,normal
437,0,14,Saturday,50,18,26,14,108,normal
438,0,14,Saturday,120,28,22,20,190,heavy
439,0,14,Saturday,60,14,28,9,111,normal
440,0,14,Saturday,105,14,8,19,146,normal
441,0,14,Saturday,89,27,18,8,142,normal
442,0,14,Saturday,28,17,31,10,86,normal
443,0,14,Saturday,79,14,23,6,122,normal
444,0,14,Saturday,15,11,30,14,70,normal
445,0,14,Saturday,77,27,23,18,145,normal
446,0,14,Saturday,19,14,24,6,63,normal
447,0,14,Saturday,79,13,28,7,127,high
448,0,14,Saturday,114,10,22,9,155,normal
449,0,14,Saturday,150,30,22,5,207,heavy
450,0,14,Saturday,142,23,25,7,197,heavy
451,0,14,Saturday,111,36,25,6,178,heavy
452,0,14,Saturday,143,37,38,8,226,heavy
453,0,14,Saturday,120,37,43,10,210,heavy
454,0,14,Saturday,147,20,49,7,223,normal
455,0,14,Saturday,140,22,27,5,194,heavy
456,0,14,Saturday,128,37,20,9,194,heavy
457,0,14,Saturday,114,23,42,10,189,heavy
458,0,14,Saturday,117,20,22,9,168,heavy
459,0,14,Saturday,93,24,17,23,157,high
460,0,14,Saturday,65,15,15,8,103,low
461,0,14,Saturday,100,22,14,8,144,normal
462,0,14,Saturday,85,12,11,18,126,normal
463,0,14,Saturday,56,7,12,12,87,low
464,0,14,Saturday,50,12,15,18,95,normal
465,0,14,Saturday,74,9,11,12,106,low
466,0,14,Saturday,73,15,18,7,113,normal
467,0,14,Saturday,99,13,20,30,162,high
468,0,14,Saturday,110,14,17,8,149,normal
469,0,14,Saturday,82,5,12,34,133,high
470,0,14,Saturday,58,19,12,17,106,normal
471,0,14,Saturday,70,10,14,32,126,high
472,0,14,Saturday,10,1,0,33,44,normal
473,0,14,Saturday,14,1,1,40,56,normal
474,0,14,Saturday,17,1,1,17,36,normal
475,0,14,Saturday,12,4,1,22,39,normal
476,0,14,Saturday,15,0,0,16,31,normal
477,0,14,Saturday,13,4,0,25,42,normal
478,0,14,Saturday,14,5,1,12,32,low
479,0,14,Saturday,18,1,1,35,55,normal
480,0,15,Sunday,18,5,1,19,43,normal
481,0,15,Sunday,19,3,0,38,60,normal
482,0,15,Sunday,13,0,1,12,26,low
483,0,15,Sunday,20,0,1,38,59,normal
484,0,15,Sunday,20,1,1,24,46,normal
485,0,15,Sunday,17,3,1,17,38,normal
486,0,15,Sunday,12,3,1,35,51,normal
487,0,15,Sunday,19,0,1,30,50,normal
488,0,15,Sunday,19,2,1,30,52,normal
489,0,15,Sunday,18,1,0,16,35,normal
490,0,15,Sunday,11,0,0,31,42,normal
491,0,15,Sunday,10,1,1,12,24,low
492,0,15,Sunday,16,1,0,24,41,normal
493,0,15,Sunday,18,3,0,28,49,normal
494,0,15,Sunday,20,1,1,39,61,normal
495,0,15,Sunday,19,3,1,27,50,normal
496,0,15,Sunday,14,1,1,34,50,normal
497,0,15,Sunday,61,26,1,16,104,normal
498,0,15,Sunday,72,26,6,4,108,low
499,0,15,Sunday,86,24,3,18,131,normal
500,0,15,Sunday,75,1,8,10,94,low
501,0,15,Sunday,75,1,7,9,92,low
502,0,15,Sunday,93,5,4,1,103,low
503,0,15,Sunday,111,6,2,5,124,normal
504,0,15,Sunday,111,18,41,2,172,heavy
505,0,15,Sunday,114,27,46,0,187,heavy
506,0,15,Sunday,139,19,50,2,210,heavy
507,0,15,Sunday,109,14,38,1,162,high
508,0,15,Sunday,105,16,22,3,146,normal
509,0,15,Sunday,150,13,31,4,198,heavy
510,0,15,Sunday,122,13,47,3,185,heavy
511,0,15,Sunday,114,24,46,2,186,heavy
512,0,15,Sunday,119,36,41,0,196,heavy
513,0,15,Sunday,108,35,39,0,182,heavy
514,0,15,Sunday,113,18,28,1,160,high
515,0,15,Sunday,118,36,37,0,191,heavy
516,0,15,Sunday,113,35,48,3,199,heavy
517,0,15,Sunday,66,7,22,30,125,high
518,0,15,Sunday,64,12,27,8,111,normal
519,0,15,Sunday,37,5,13,11,66,low
520,0,15,Sunday,82,17,31,20,150,high
521,0,15,Sunday,63,5,23,12,103,normal
522,0,15,Sunday,20,12,16,24,72,normal
523,0,15,Sunday,46,5,34,9,94,normal
524,0,15,Sunday,35,9,8,29,81,normal
525,0,15,Sunday,33,9,11,21,74,normal
526,0,15,Sunday,32,9,10,30,81,normal
527,0,15,Sunday,62,10,6,22,100,normal
528,0,15,Sunday,62,10,11,22,105,normal
529,0,15,Sunday,54,10,12,25,101,normal
530,0,15,Sunday,48,8,15,23,94,normal
531,0,15,Sunday,20,10,12,24,66,normal
532,0,15,Sunday,35,10,5,30,80,normal
533,0,15,Sunday,112,15,40,10,177,heavy
534,0,15,Sunday,51,21,25,13,110,normal
535,0,15,Sunday,53,12,23,8,96,normal
536,0,15,Sunday,63,22,18,15,118,normal
537,0,15,Sunday,50,23,16,8,97,normal
538,0,15,Sunday,94,20,35,17,166,high
539,0,15,Sunday,7,27,39,17,90,normal
540,0,15,Sunday,109,18,13,6,146,normal
541,0,15,Sunday,18,27,19,6,70,normal
542,0,15,Sunday,21,30,5,5,61,low
543,0,15,Sunday,49,16,9,12,86,low
544,0,15,Sunday,129,28,40,6,203,heavy
545,0,15,Sunday,141,18,28,8,195,heavy
546,0,15,Sunday,131,14,43,7,195,heavy
547,0,15,Sunday,105,38,23,5,171,heavy
548,0,15,Sunday,125,35,37,5,202,heavy
549,0,15,Sunday,127,36,42,9,214,heavy
550,0,15,Sunday,129,22,25,9,185,heavy
551,0,15,Sunday,121,39,47,8,215,heavy
552,0,15,Sunday,138,29,42,9,218,heavy
553,0,15,Sunday,119,26,21,5,171,heavy
554,0,15,Sunday,138,17,48,8,211,heavy
555,0,15,Sunday,72,12,14,32,130,high
556,0,15,Sunday,92,23,20,30,165,high
557,0,15,Sunday,94,17,11,24,146,high
558,0,15,Sunday,102,25,12,24,163,high
559,0,15,Sunday,71,23,17,14,125,normal
560,0,15,Sunday,58,5,19,25,107,normal
561,0,15,Sunday,93,22,18,10,143,normal
562,0,15,Sunday,59,23,10,35,127,high
563,0,15,Sunday,57,20,10,20,107,normal
564,0,15,Sunday,96,9,18,25,148,high
565,0,15,Sunday,104,12,16,20,152,normal
566,0,15,Sunday,104,22,17,23,166,high
567,0,15,Sunday,88,8,11,29,136,high
568,0,15,Sunday,20,3,0,16,39,normal
569,0,15,Sunday,17,2,1,30,50,normal
570,0,15,Sunday,17,4,0,23,44,normal
571,0,15,Sunday,15,5,0,21,41,normal
572,0,15,Sunday,10,0,1,31,42,normal
573,0,15,Sunday,11,1,1,19,32,normal
574,0,15,Sunday,12,2,0,29,43,normal
575,0,15,Sunday,11,0,1,11,23,low
576,0,16,Monday,18,4,1,28,51,normal
577,0,16,Monday,13,3,0,26,42,normal
578,0,16,Monday,16,3,0,34,53,normal
579,0,16,Monday,16,4,0,35,55,normal
580,0,16,Monday,20,2,1,33,56,normal
581,0,16,Monday,14,4,1,28,47,normal
582,0,16,Monday,11,4,1,19,35,normal
583,0,16,Monday,19,4,0,17,40,normal
584,0,16,Monday,18,3,1,26,48,normal
585,0,16,Monday,10,1,1,21,33,normal
586,0,16,Monday,20,5,1,40,66,normal
587,0,16,Monday,11,5,0,37,53,normal
588,0,16,Monday,15,4,1,29,49,normal
589,0,16,Monday,16,2,1,27,46,normal
590,0,16,Monday,10,3,1,23,37,normal
591,0,16,Monday,16,5,1,31,53,normal
592,0,16,Monday,20,0,1,30,51,normal
593,0,16,Monday,61,4,5,17,87,normal
594,0,16,Monday,91,8,6,2,107,low
595,0,16,Monday,94,4,5,2,105,low
596,0,16,Monday,117,8,6,16,147,normal
597,0,16,Monday,111,14,10,14,149,normal
598,0,16,Monday,91,2,3,5,101,low
599,0,16,Monday,96,9,1,16,122,normal
600,0,16,Monday,134,15,42,5,196,heavy
601,0,16,Monday,121,35,39,4,199,heavy
602,0,16,Monday,118,40,40,3,201,heavy
603,0,16,Monday,115,17,40,1,173,heavy
604,0,16,Monday,106,22,37,0,165,high
605,0,16,Monday,147,26,40,0,213,heavy
606,0,16,Monday,102,13,31,2,148,high
607,0,16,Monday,102,12,24,3,141,normal
608,0,16,Monday,130,40,31,2,203,heavy
609,0,16,Monday,102,17,33,0,152,high
610,0,16,Monday,105,13,48,5,171,heavy
611,0,16,Monday,129,24,25,0,178,heavy
612,0,16,Monday,117,11,45,0,173,heavy
613,0,16,Monday,74,14,23,21,132,high
614,0,16,Monday,80,14,35,18,147,high
615,0,16,Monday,31,7,34,24,96,normal
616,0,16,Monday,18,15,9,15,57,normal
617,0,16,Monday,15,10,23,20,68,normal
618,0,16,Monday,37,18,8,16,79,normal
619,0,16,Monday,10,7,5,14,36,normal
620,0,16,Monday,54,6,15,23,98,normal
621,0,16,Monday,34,7,5,24,70,normal
622,0,16,Monday,50,7,8,21,86,normal
623,0,16,Monday,44,9,10,24,87,normal
624,0,16,Monday,63,8,15,24,110,normal
625,0,16,Monday,56,6,6,29,97,normal
626,0,16,Monday,69,5,13,27,114,high
627,0,16,Monday,39,5,3,30,77,normal
628,0,16,Monday,61,10,14,24,109,normal
629,0,16,Monday,61,30,5,20,116,normal
630,0,16,Monday,20,17,9,5,51,low
631,0,16,Monday,70,22,38,7,137,high
632,0,16,Monday,25,30,31,9,95,normal
633,0,16,Monday,23,13,12,6,54,low
634,0,16,Monday,105,30,24,8,167,normal
635,0,16,Monday,107,10,6,6,129,normal
636,0,16,Monday,40,20,36,7,103,normal
637,0,16,Monday,74,18,37,11,140,high
638,0,16,Monday,62,15,8,11,96,low
639,0,16,Monday,81,20,14,12,127,normal
640,0,16,Monday,111,32,43,5,191,heavy
641,0,16,Monday,145,12,41,6,204,heavy
642,0,16,Monday,139,11,20,7,177,heavy
643,0,16,Monday,129,40,31,10,210,heavy
644,0,16,Monday,128,22,28,8,186,heavy
645,0,16,Monday,103,17,23,8,151,normal
646,0,16,Monday,127,32,29,7,195,heavy
647,0,16,Monday,120,35,44,8,207,heavy
648,0,16,Monday,106,11,41,7,165,high
649,0,16,Monday,114,40,31,5,190,heavy
650,0,16,Monday,101,13,20,7,141,normal
651,0,16,Monday,110,25,19,34,188,heavy
652,0,16,Monday,108,6,17,23,154,high
653,0,16,Monday,104,12,10,10,136,normal
654,0,16,Monday,102,22,17,23,164,high
655,0,16,Monday,77,19,16,8,120,normal
656,0,16,Monday,70,16,19,33,138,high
657,0,16,Monday,75,9,13,28,125,high
658,0,16,Monday,95,9,16,29,149,high
659,0,16,Monday,77,17,17,22,133,high
660,0,16,Monday,73,16,14,34,137,high
661,0,16,Monday,59,7,18,12,96,normal
662,0,16,Monday,54,20,10,9,93,low
663,0,16,Monday,90,6,18,32,146,high
664,0,16,Monday,15,5,1,32,53,normal
665,0,16,Monday,12,1,0,11,24,low
666,0,16,Monday,17,2,0,28,47,normal
667,0,16,Monday,13,5,1,12,31,low
668,0,16,Monday,15,5,0,21,41,normal
669,0,16,Monday,18,4,0,11,33,low
670,0,16,Monday,12,4,0,21,37,normal
671,0,16,Monday,10,4,1,12,27,low
672,0,17,Tuesday,15,2,0,25,42,normal
673,0,17,Tuesday,11,0,0,24,35,normal
674,0,17,Tuesday,15,2,1,15,33,normal
675,0,17,Tuesday,20,3,1,29,53,normal
676,0,17,Tuesday,17,2,0,24,43,normal
677,0,17,Tuesday,19,5,1,26,51,normal
678,0,17,Tuesday,20,3,1,32,56,normal
679,0,17,Tuesday,15,3,0,19,37,normal
680,0,17,Tuesday,13,5,0,17,35,normal
681,0,17,Tuesday,12,5,1,19,37,normal
682,0,17,Tuesday,10,2,0,27,39,normal
683,0,17,Tuesday,20,4,1,23,48,normal
684,0,17,Tuesday,14,0,0,16,30,normal
685,0,17,Tuesday,12,4,1,28,45,normal
686,0,17,Tuesday,19,2,0,20,41,normal
687,0,17,Tuesday,20,2,1,19,42,normal
688,0,17,Tuesday,16,0,0,36,52,normal
689,0,17,Tuesday,62,20,4,18,104,normal
690,0,17,Tuesday,50,13,2,14,79,normal
691,0,17,Tuesday,101,3,6,6,116,normal
692,0,17,Tuesday,94,15,2,9,120,normal
693,0,17,Tuesday,68,10,8,1,87,low
694,0,17,Tuesday,95,3,8,20,126,normal
695,0,17,Tuesday,113,7,10,16,146,normal
696,0,17,Tuesday,106,13,39,1,159,high
697,0,17,Tuesday,105,32,47,4,188,heavy
698,0,17,Tuesday,150,19,34,4,207,heavy
699,0,17,Tuesday,137,38,39,2,216,heavy
700,0,17,Tuesday,113,11,32,1,157,high
701,0,17,Tuesday,117,30,26,5,178,heavy
702,0,17,Tuesday,130,10,37,1,178,heavy
703,0,17,Tuesday,150,32,31,1,214,heavy
704,0,17,Tuesday,146,10,30,3,189,heavy
705,0,17,Tuesday,123,24,46,2,195,heavy
706,0,17,Tuesday,110,24,26,4,164,high
707,0,17,Tuesday,111,33,31,2,177,heavy
708,0,17,Tuesday,132,18,32,2,184,heavy
709,0,17,Tuesday,66,16,22,13,117,normal
710,0,17,Tuesday,45,24,5,23,97,normal
711,0,17,Tuesday,92,19,15,7,133,normal
712,0,17,Tuesday,78,22,16,25,141,high
713,0,17,Tuesday,90,2,15,18,125,normal
714,0,17,Tuesday,23,2,37,9,71,normal
715,0,17,Tuesday,17,5,6,20,48,normal
716,0,17,Tuesday,41,5,4,24,74,normal
717,0,17,Tuesday,32,5,15,26,78,normal
718,0,17,Tuesday,65,7,7,22,101,normal
719,0,17,Tuesday,22,6,3,25,56,normal
720,0,17,Tuesday,54,7,4,28,93,normal
721,0,17,Tuesday,38,5,8,28,79,normal
722,0,17,Tuesday,59,7,15,23,104,normal
723,0,17,Tuesday,34,8,10,23,75,normal
724,0,17,Tuesday,28,6,3,27,64,normal
725,0,17,Tuesday,7,16,11,14,48,normal
726,0,17,Tuesday,8,12,22,8,50,normal
727,0,17,Tuesday,42,25,38,18,123,high
728,0,17,Tuesday,82,13,28,5,128,high
729,0,17,Tuesday,14,24,26,9,73,normal
730,0,17,Tuesday,39,25,33,9,106,normal
731,0,17,Tuesday,47,14,29,6,96,normal
732,0,17,Tuesday,120,20,21,18,179,heavy
733,0,17,Tuesday,114,11,39,10,174,heavy
734,0,17,Tuesday,99,24,30,10,163,high
735,0,17,Tuesday,78,18,30,8,134,high
736,0,17,Tuesday,144,40,29,10,223,normal
737,0,17,Tuesday,107,28,38,9,182,heavy
738,0,17,Tuesday,123,28,24,10,185,heavy
739,0,17,Tuesday,126,15,28,6,175,heavy
740,0,17,Tuesday,147,28,23,5,203,heavy
741,0,17,Tuesday,100,21,33,7,161,high
742,0,17,Tuesday,113,12,22,6,153,normal
743,0,17,Tuesday,130,34,30,6,200,heavy
744,0,17,Tuesday,118,40,29,10,197,heavy
745,0,17,Tuesday,113,38,44,9,204,heavy
746,0,17,Tuesday,117,29,29,9,184,heavy
747,0,17,Tuesday,106,12,20,32,170,heavy
748,0,17,Tuesday,96,11,15,14,136,normal
749,0,17,Tuesday,58,11,14,24,107,normal
750,0,17,Tuesday,76,22,10,9,117,normal
751,0,17,Tuesday,66,6,12,33,117,high
752,0,17,Tuesday,61,23,13,18,115,normal
753,0,17,Tuesday,93,6,15,17,131,normal
754,0,17,Tuesday,51,11,16,26,104,normal
755,0,17,Tuesday,86,6,12,9,113,normal
756,0,17,Tuesday,77,15,12,29,133,high
757,0,17,Tuesday,84,15,16,8,123,normal
758,0,17,Tuesday,103,12,15,10,140,normal
759,0,17,Tuesday,60,9,11,27,107,normal
760,0,17,Tuesday,14,1,1,22,38,normal
761,0,17,Tuesday,14,2,0,35,51,normal
762,0,17,Tuesday,13,1,1,31,46,normal
763,0,17,Tuesday,19,0,1,22,42,normal
764,0,17,Tuesday,13,4,0,28,45,normal
765,0,17,Tuesday,13,1,0,26,40,normal
766,0,17,Tuesday,12,0,1,34,47,normal
767,0,17,Tuesday,20,1,1,38,60,normal
768,0,18,Wednesday,12,3,0,38,53,normal
769,0,18,Wednesday,12,1,0,40,53,normal
770,0,18,Wednesday,20,5,0,10,35,low
771,0,18,Wednesday,12,4,1,27,44,normal
772,0,18,Wednesday,15,5,0,21,41,normal
773,0,18,Wednesday,19,2,0,30,51,normal
774,0,18,Wednesday,11,0,1,40,52,normal
775,0,18,Wednesday,15,3,0,35,53,normal
776,0,18,Wednesday,15,0,1,37,53,normal
777,0,18,Wednesday,16,2,0,37,55,normal
778,0,18,Wednesday,10,0,1,24,35,normal
779,0,18,Wednesday,12,0,1,31,44,normal
780,0,18,Wednesday,15,1,1,36,53,normal
781,0,18,Wednesday,14,5,0,17,36,normal
782,0,18,Wednesday,17,3,1,38,59,normal
783,0,18,Wednesday,19,0,0,18,37,normal
784,0,18,Wednesday,18,5,1,30,54,normal
785,0,18,Wednesday,119,12,6,4,141,normal
786,0,18,Wednesday,74,28,1,13,116,normal
787,0,18,Wednesday,101,26,10,0,137,normal
788,0,18,Wednesday,99,4,7,19,129,normal
789,0,18,Wednesday,99,18,7,5,129,normal
790,0,18,Wednesday,102,24,2,8,136,normal
791,0,18,Wednesday,50,4,6,13,73,normal
792,0,18,Wednesday,128,11,46,4,189,heavy
793,0,18,Wednesday,129,39,43,0,211,heavy
794,0,18,Wednesday,129,27,38,0,194,heavy
795,0,18,Wednesday,113,24,22,2,161,normal
796,0,18,Wednesday,141,15,21,5,182,heavy
797,0,18,Wednesday,120,22,29,1,172,heavy
798,0,18,Wednesday,141,24,47,4,216,heavy
799,0,18,Wednesday,149,24,33,1,207,heavy
800,0,18,Wednesday,140,40,36,1,217,heavy
801,0,18,Wednesday,140,20,36,0,196,heavy
802,0,18,Wednesday,107,13,31,4,155,high
803,0,18,Wednesday,141,15,32,4,192,heavy
804,0,18,Wednesday,120,27,38,4,189,heavy
805,0,18,Wednesday,70,14,21,5,110,normal
806,0,18,Wednesday,55,24,16,21,116,high
807,0,18,Wednesday,52,18,22,16,108,normal
808,0,18,Wednesday,65,4,19,21,109,normal
809,0,18,Wednesday,54,10,30,28,122,high
810,0,18,Wednesday,37,3,32,18,90,normal
811,0,18,Wednesday,23,3,37,18,81,normal
812,0,18,Wednesday,43,7,7,29,86,normal
813,0,18,Wednesday,22,6,13,24,65,normal
814,0,18,Wednesday,21,10,6,30,67,normal
815,0,18,Wednesday,48,8,11,22,89,normal
816,0,18,Wednesday,35,5,12,20,72,normal
817,0,18,Wednesday,69,5,13,22,109,normal
818,0,18,Wednesday,22,9,10,21,62,normal
819,0,18,Wednesday,46,5,9,23,83,normal
820,0,18,Wednesday,49,5,11,21,86,normal
821,0,18,Wednesday,29,18,29,20,96,normal
822,0,18,Wednesday,96,23,31,14,164,high
823,0,18,Wednesday,100,27,23,16,166,normal
824,0,18,Wednesday,96,22,36,5,159,high
825,0,18,Wednesday,27,26,25,15,93,normal
826,0,18,Wednesday,114,21,32,5,172,heavy
827,0,18,Wednesday,74,27,34,10,145,high
828,0,18,Wednesday,14,16,9,14,53,normal
829,0,18,Wednesday,84,30,26,10,150,high
830,0,18,Wednesday,96,19,14,18,147,normal
831,0,18,Wednesday,40,15,28,5,88,normal
832,0,18,Wednesday,110,15,46,5,176,heavy
833,0,18,Wednesday,138,39,31,7,215,heavy
834,0,18,Wednesday,118,32,32,10,192,heavy
835,0,18,Wednesday,142,34,38,9,223,normal
836,0,18,Wednesday,113,13,36,5,167,normal
837,0,18,Wednesday,104,29,32,7,172,heavy
838,0,18,Wednesday,134,39,21,9,203,heavy
839,0,18,Wednesday,107,15,48,5,175,heavy
840,0,18,Wednesday,139,25,43,7,214,heavy
841,0,18,Wednesday,128,20,20,6,174,heavy
842,0,18,Wednesday,101,13,47,10,171,heavy
843,0,18,Wednesday,105,17,13,23,158,high
844,0,18,Wednesday,103,14,13,9,139,normal
845,0,18,Wednesday,51,23,15,13,102,normal
846,0,18,Wednesday,84,10,16,20,130,normal
847,0,18,Wednesday,97,25,19,24,165,high
848,0,18,Wednesday,98,8,10,19,135,normal
849,0,18,Wednesday,94,13,19,25,151,high
850,0,18,Wednesday,105,25,11,35,176,heavy
851,0,18,Wednesday,74,9,13,6,102,low
852,0,18,Wednesday,57,18,13,28,116,high
853,0,18,Wednesday,57,14,11,33,115,high
854,0,18,Wednesday,84,23,19,15,141,normal
855,0,18,Wednesday,105,14,16,33,168,heavy
856,0,18,Wednesday,10,4,1,38,53,normal
857,0,18,Wednesday,15,1,1,29,46,normal
858,0,18,Wednesday,14,1,1,25,41,normal
859,0,18,Wednesday,20,2,0,37,59,normal
860,0,18,Wednesday,20,1,0,27,48,normal
861,0,18,Wednesday,13,1,1,18,33,normal
862,0,18,Wednesday,19,0,0,35,54,normal
863,0,18,Wednesday,14,1,1,27,43,normal
864,0,19,Thursday,13,5,0,12,30,low
865,0,19,Thursday,18,5,0,12,35,low
866,0,19,Thursday,10,3,1,32,46,normal
867,0,19,Thursday,14,2,0,15,31,normal
868,0,19,Thursday,16,3,0,15,34,normal
869,0,19,Thursday,14,2,0,25,41,normal
870,0,19,Thursday,17,5,0,18,40,normal
871,0,19,Thursday,13,1,0,28,42,normal
872,0,19,Thursday,19,0,1,20,40,normal
873,0,19,Thursday,15,4,0,40,59,normal
874,0,19,Thursday,14,3,1,26,44,normal
875,0,19,Thursday,15,4,0,14,33,normal
876,0,19,Thursday,12,3,1,13,29,normal
877,0,19,Thursday,12,4,0,31,47,normal
878,0,19,Thursday,17,4,1,20,42,normal
879,0,19,Thursday,12,0,1,13,26,normal
880,0,19,Thursday,18,2,0,16,36,normal
881,0,19,Thursday,115,16,10,13,154,normal
882,0,19,Thursday,117,5,10,15,147,normal
883,0,19,Thursday,92,26,8,7,133,normal
884,0,19,Thursday,88,3,6,4,101,low
885,0,19,Thursday,109,11,4,3,127,normal
886,0,19,Thursday,81,4,0,20,105,normal
887,0,19,Thursday,118,2,5,19,144,normal
888,0,19,Thursday,107,26,31,2,166,high
889,0,19,Thursday,103,11,35,5,154,high
890,0,19,Thursday,145,13,33,3,194,heavy
891,0,19,Thursday,143,22,37,4,206,heavy
892,0,19,Thursday,113,38,50,3,204,heavy
893,0,19,Thursday,149,10,47,3,209,heavy
894,0,19,Thursday,132,33,35,2,202,heavy
895,0,19,Thursday,119,40,41,2,202,heavy
896,0,19,Thursday,133,31,27,2,193,heavy
897,0,19,Thursday,140,20,44,4,208,heavy
898,0,19,Thursday,140,34,31,1,206,heavy
899,0,19,Thursday,128,37,50,2,217,heavy
900,0,19,Thursday,132,11,24,3,170,heavy
901,0,19,Thursday,23,8,40,27,98,normal
902,0,19,Thursday,75,2,18,29,124,high
903,0,19,Thursday,99,14,33,14,160,high
904,0,19,Thursday,10,1,13,7,31,low
905,0,19,Thursday,74,21,29,26,150,high
906,0,19,Thursday,29,15,25,5,74,normal
907,0,19,Thursday,50,17,38,24,129,high
908,0,19,Thursday,64,9,14,20,107,normal
909,0,19,Thursday,49,5,10,21,85,normal
910,0,19,Thursday,39,7,10,30,86,normal
911,0,19,Thursday,68,5,5,24,102,normal
912,0,19,Thursday,67,7,8,22,104,normal
913,0,19,Thursday,47,8,3,25,83,normal
914,0,19,Thursday,66,9,7,24,106,normal
915,0,19,Thursday,46,8,3,22,79,normal
916,0,19,Thursday,54,6,12,21,93,normal
917,0,19,Thursday,18,16,32,18,84,normal
918,0,19,Thursday,24,20,7,9,60,low
919,0,19,Thursday,113,17,16,20,166,normal
920,0,19,Thursday,52,13,15,10,90,low
921,0,19,Thursday,58,26,25,18,127,normal
922,0,19,Thursday,44,19,22,6,91,normal
923,0,19,Thursday,8,26,34,9,77,normal
924,0,19,Thursday,31,10,27,8,76,normal
925,0,19,Thursday,115,24,16,5,160,normal
926,0,19,Thursday,56,29,16,16,117,normal
927,0,19,Thursday,7,12,33,12,64,normal
928,0,19,Thursday,133,10,46,10,199,heavy
929,0,19,Thursday,104,31,37,6,178,heavy
930,0,19,Thursday,100,38,36,9,183,heavy
931,0,19,Thursday,127,25,37,5,194,heavy
932,0,19,Thursday,118,32,48,6,204,heavy
933,0,19,Thursday,147,19,31,8,205,heavy
934,0,19,Thursday,123,36,34,5,198,heavy
935,0,19,Thursday,111,24,25,5,165,normal
936,0,19,Thursday,121,16,42,8,187,heavy
937,0,19,Thursday,119,38,47,7,211,heavy
938,0,19,Thursday,132,30,41,6,209,heavy
939,0,19,Thursday,52,6,12,18,88,normal
940,0,19,Thursday,97,21,10,8,136,normal
941,0,19,Thursday,50,16,20,31,117,high
942,0,19,Thursday,94,25,19,8,146,normal
943,0,19,Thursday,66,11,18,34,129,high
944,0,19,Thursday,105,16,15,6,142,normal
945,0,19,Thursday,56,23,10,18,107,normal
946,0,19,Thursday,105,19,10,25,159,high
947,0,19,Thursday,60,18,11,16,105,normal
948,0,19,Thursday,88,10,14,11,123,normal
949,0,19,Thursday,110,6,14,23,153,high
950,0,19,Thursday,78,20,11,35,144,high
951,0,19,Thursday,105,14,10,7,136,normal
952,0,19,Thursday,18,1,0,10,29,low
953,0,19,Thursday,18,1,0,27,46,normal
954,0,19,Thursday,12,4,1,18,35,normal
955,0,19,Thursday,15,4,1,32,52,normal
956,0,19,Thursday,13,4,0,32,49,normal
957,0,19,Thursday,14,4,0,15,33,normal
958,0,19,Thursday,15,4,0,17,36,normal
959,0,19,Thursday,14,0,1,21,36,normal
960,0,20,Friday,17,5,0,37,59,normal
961,0,20,Friday,14,4,1,12,31,low
962,0,20,Friday,16,2,0,15,33,normal
963,0,20,Friday,13,4,1,14,32,normal
964,0,20,Friday,12,4,0,29,45,normal
965,0,20,Friday,19,4,1,30,54,normal
966,0,20,Friday,18,4,0,18,40,normal
967,0,20,Friday,18,1,1,12,32,low
968,0,20,Friday,20,4,1,21,46,normal
969,0,20,Friday,10,2,1,20,33,normal
970,0,20,Friday,18,5,1,23,47,normal
971,0,20,Friday,16,5,1,30,52,normal
972,0,20,Friday,12,3,0,40,55,normal
973,0,20,Friday,12,2,0,40,54,normal
974,0,20,Friday,16,0,1,37,54,normal
975,0,20,Friday,15,4,1,16,36,normal
976,0,20,Friday,13,0,0,38,51,normal
977,0,20,Friday,61,5,3,14,83,normal
978,0,20,Friday,27,15,6,10,58,low
979,0,20,Friday,74,11,5,15,105,normal
980,0,20,Friday,70,6,7,14,97,normal
981,0,20,Friday,33,6,0,11,50,low
982,0,20,Friday,29,12,1,13,55,normal
983,0,20,Friday,69,5,7,10,91,low
984,0,20,Friday,41,16,7,15,79,normal
985,0,20,Friday,35,11,5,11,62,low
986,0,20,Friday,25,9,6,14,54,normal
987,0,20,Friday,65,15,1,11,92,low
988,0,20,Friday,66,6,3,14,89,normal
989,0,20,Friday,27,6,5,15,53,normal
990,0,20,Friday,75,6,1,10,92,low
991,0,20,Friday,54,11,4,12,81,low
992,0,20,Friday,54,18,3,12,87,low
993,0,20,Friday,69,8,0,14,91,normal
994,0,20,Friday,52,19,6,10,87,low
995,0,20,Friday,66,8,0,12,86,low
996,0,20,Friday,54,11,0,13,78,normal
997,0,20,Friday,151,48,15,3,217,heavy
998,0,20,Friday,170,62,18,2,252,heavy
999,0,20,Friday,134,59,11,3,207,heavy
1000,0,20,Friday,166,63,22,1,252,heavy
1001,0,20,Friday,173,64,10,2,249,heavy
1002,0,20,Friday,176,45,22,2,245,heavy
1003,0,20,Friday,162,59,27,1,249,heavy
1004,0,20,Friday,171,46,15,3,235,heavy
1005,0,20,Friday,158,44,26,2,230,heavy
1006,0,20,Friday,151,64,16,0,231,heavy
1007,0,20,Friday,162,65,14,3,244,heavy
1008,0,20,Friday,179,44,23,1,247,heavy
1009,0,20,Friday,175,59,11,3,248,heavy
1010,0,20,Friday,173,63,13,2,251,heavy
1011,0,20,Friday,144,66,11,3,224,heavy
1012,0,20,Friday,132,68,22,4,226,heavy
1013,0,20,Friday,161,50,10,0,221,heavy
1014,0,20,Friday,151,56,29,1,237,heavy
1015,0,20,Friday,168,59,24,1,252,heavy
1016,0,20,Friday,144,65,20,3,232,heavy
1017,0,20,Friday,179,63,12,2,256,heavy
1018,0,20,Friday,161,56,12,4,233,heavy
1019,0,20,Friday,134,67,12,1,214,heavy
1020,0,20,Friday,140,70,23,4,237,heavy
1021,0,20,Friday,66,29,24,1,120,normal
1022,0,20,Friday,60,27,17,2,106,normal
1023,0,20,Friday,89,27,10,2,128,normal
1024,0,20,Friday,81,29,5,0,115,normal
1025,0,20,Friday,78,22,12,1,113,normal
1026,0,20,Friday,71,24,18,2,115,normal
1027,0,20,Friday,50,26,9,1,86,low
1028,0,20,Friday,55,28,5,0,88,low
1029,0,20,Friday,61,20,25,1,107,normal
1030,0,20,Friday,76,22,14,2,114,normal
1031,0,20,Friday,50,20,23,1,94,normal
1032,0,20,Friday,89,26,0,2,117,normal
1033,0,20,Friday,62,20,17,0,99,normal
1034,0,20,Friday,83,20,23,2,128,normal
1035,0,20,Friday,65,20,2,0,87,low
1036,0,20,Friday,60,21,2,1,84,low
1037,0,20,Friday,36,8,3,9,56,low
1038,0,20,Friday,39,5,4,11,59,low
1039,0,20,Friday,26,8,3,0,37,low
1040,0,20,Friday,23,4,0,5,32,low
1041,0,20,Friday,50,2,0,4,56,low
1042,0,20,Friday,30,2,3,1,36,low
1043,0,20,Friday,48,10,4,2,64,low
1044,0,20,Friday,39,6,6,1,52,low
1045,0,20,Friday,47,10,3,9,69,low
1046,0,20,Friday,26,3,5,3,37,low
1047,0,20,Friday,25,6,3,9,43,low
1048,0,20,Friday,19,1,0,11,31,low
1049,0,20,Friday,16,5,0,26,47,normal
1050,0,20,Friday,15,2,1,39,57,normal
1051,0,20,Friday,14,5,0,11,30,low
1052,0,20,Friday,12,2,0,20,34,normal
1053,0,20,Friday,11,2,0,35,48,normal
1054,0,20,Friday,18,5,1,11,35,low
1055,0,20,Friday,17,2,0,20,39,normal
1056,0,21,Sunday,19,5,1,30,55,normal
1057,0,21,Sunday,17,4,1,24,46,normal
1058,0,21,Sunday,16,3,0,14,33,normal
1059,0,21,Sunday,16,3,1,23,43,normal
1060,0,21,Sunday,20,0,1,17,38,normal
1061,0,21,Sunday,20,0,0,37,57,normal
1062,0,21,Sunday,18,0,1,30,49,normal
1063,0,21,Sunday,19,1,0,14,34,normal
1064,0,21,Sunday,18,5,0,29,52,normal
1065,0,21,Sunday,11,1,0,22,34,normal
1066,0,21,Sunday,20,3,0,24,47,normal
1067,0,21,Sunday,12,2,1,10,25,low
1068,0,21,Sunday,19,5,1,31,56,normal
1069,0,21,Sunday,10,0,0,32,42,normal
1070,0,21,Sunday,14,1,1,12,28,low
1071,0,21,Sunday,14,2,1,24,41,normal
1072,0,21,Sunday,10,3,0,32,45,normal
1073,0,21,Sunday,97,23,6,17,143,normal
1074,0,21,Sunday,104,22,7,11,144,normal
1075,0,21,Sunday,100,15,8,20,143,normal
1076,0,21,Sunday,87,7,7,4,105,low
1077,0,21,Sunday,77,27,8,10,122,normal
1078,0,21,Sunday,51,7,4,5,67,low
1079,0,21,Sunday,79,1,10,6,96,low
1080,0,21,Sunday,100,40,29,5,174,heavy
1081,0,21,Sunday,112,13,39,0,164,high
1082,0,21,Sunday,120,16,34,2,172,heavy
1083,0,21,Sunday,123,14,26,3,166,high
1084,0,21,Sunday,142,27,27,4,200,heavy
1085,0,21,Sunday,139,38,49,2,228,heavy
1086,0,21,Sunday,134,24,21,2,181,heavy
1087,0,21,Sunday,102,13,31,0,146,high
1088,0,21,Sunday,102,16,43,4,165,high
1089,0,21,Sunday,106,16,32,1,155,high
1090,0,21,Sunday,117,19,42,3,181,heavy
1091,0,21,Sunday,139,36,40,3,218,heavy
1092,0,21,Sunday,121,13,25,2,161,normal
1093,0,21,Sunday,65,19,16,11,111,normal
1094,0,21,Sunday,12,25,39,28,104,normal
1095,0,21,Sunday,98,21,10,5,134,normal
1096,0,21,Sunday,58,9,25,13,105,normal
1097,0,21,Sunday,81,10,39,29,159,high
1098,0,21,Sunday,67,20,33,29,149,high
1099,0,21,Sunday,68,22,25,16,131,normal
1100,0,21,Sunday,47,10,6,22,85,normal
1101,0,21,Sunday,45,7,10,27,89,normal
1102,0,21,Sunday,54,5,11,24,94,normal
1103,0,21,Sunday,61,7,15,28,111,normal
1104,0,21,Sunday,56,5,4,29,94,normal
1105,0,21,Sunday,23,5,4,27,59,normal
1106,0,21,Sunday,31,6,8,23,68,normal
1107,0,21,Sunday,27,7,14,28,76,normal
1108,0,21,Sunday,30,7,3,30,70,normal
1109,0,21,Sunday,114,21,5,14,154,normal
1110,0,21,Sunday,46,24,35,16,121,high
1111,0,21,Sunday,68,29,29,20,146,high
1112,0,21,Sunday,45,16,15,5,81,low
1113,0,21,Sunday,86,13,11,20,130,normal
1114,0,21,Sunday,44,11,19,15,89,normal
1115,0,21,Sunday,45,17,13,20,95,normal
1116,0,21,Sunday,106,17,7,12,142,normal
1117,0,21,Sunday,44,16,9,13,82,normal
1118,0,21,Sunday,77,23,13,9,122,normal
1119,0,21,Sunday,53,17,26,8,104,normal
1120,0,21,Sunday,138,18,20,8,184,heavy
1121,0,21,Sunday,142,24,39,9,214,heavy
1122,0,21,Sunday,114,25,21,7,167,normal
1123,0,21,Sunday,116,35,42,6,199,heavy
1124,0,21,Sunday,149,22,37,8,216,heavy
1125,0,21,Sunday,100,12,39,7,158,high
1126,0,21,Sunday,101,23,45,5,174,heavy
1127,0,21,Sunday,122,40,48,10,220,heavy
1128,0,21,Sunday,112,34,39,9,194,heavy
1129,0,21,Sunday,112,12,41,5,170,heavy
1130,0,21,Sunday,116,22,23,7,168,heavy
1131,0,21,Sunday,90,13,15,33,151,high
1132,0,21,Sunday,85,14,14,13,126,normal
1133,0,21,Sunday,59,25,13,27,124,high
1134,0,21,Sunday,108,5,15,22,150,high
1135,0,21,Sunday,75,8,16,25,124,high
1136,0,21,Sunday,96,15,12,27,150,high
1137,0,21,Sunday,61,17,10,8,96,low
1138,0,21,Sunday,84,25,20,30,159,high
1139,0,21,Sunday,55,9,12,19,95,normal
1140,0,21,Sunday,65,16,12,32,125,high
1141,0,21,Sunday,87,16,10,16,129,normal
1142,0,21,Sunday,75,5,12,21,113,high
1143,0,21,Sunday,82,16,14,34,146,high
1144,0,21,Sunday,11,3,0,34,48,normal
1145,0,21,Sunday,15,5,0,14,34,normal
1146,0,21,Sunday,18,5,1,13,37,normal
1147,0,21,Sunday,19,2,1,34,56,normal
1148,0,21,Sunday,20,4,1,26,51,normal
1149,0,21,Sunday,14,4,0,10,28,low
1150,0,21,Sunday,11,1,1,36,49,normal
1151,0,21,Sunday,10,2,1,15,28,normal
1152,0,22,Saturday,10,3,0,33,46,normal
1153,0,22,Saturday,14,3,0,23,40,normal
1154,0,22,Saturday,11,5,1,11,28,low
1155,0,22,Saturday,10,1,1,34,46,normal
1156,0,22,Saturday,20,4,1,17,42,normal
1157,0,22,Saturday,17,5,0,24,46,normal
1158,0,22,Saturday,12,2,1,18,33,normal
1159,0,22,Saturday,15,0,1,16,32,normal
1160,0,22,Saturday,19,5,0,15,39,normal
1161,0,22,Saturday,11,3,1,39,54,normal
1162,0,22,Saturday,14,5,0,10,29,low
1163,0,22,Saturday,20,0,1,33,54,normal
1164,0,22,Saturday,13,1,1,33,48,normal
1165,0,22,Saturday,18,2,1,12,33,low
1166,0,22,Saturday,19,2,1,23,45,normal
1167,0,22,Saturday,10,4,0,36,50,normal
1168,0,22,Saturday,13,4,0,17,34,normal
1169,0,22,Saturday,86,28,2,18,134,normal
1170,0,22,Saturday,59,29,9,14,111,normal
1171,0,22,Saturday,102,20,9,13,144,normal
1172,0,22,Saturday,114,28,8,16,166,normal
1173,0,22,Saturday,87,23,5,0,115,normal
1174,0,22,Saturday,88,5,8,13,114,normal
1175,0,22,Saturday,83,6,4,9,102,low
1176,0,22,Saturday,150,19,24,3,196,heavy
1177,0,22,Saturday,148,35,46,1,230,heavy
1178,0,22,Saturday,146,23,23,4,196,heavy
1179,0,22,Saturday,140,21,39,3,203,heavy
1180,0,22,Saturday,149,36,35,1,221,heavy
1181,0,22,Saturday,125,34,42,0,201,heavy
1182,0,22,Saturday,147,34,20,5,206,heavy
1183,0,22,Saturday,128,33,21,4,186,heavy
1184,0,22,Saturday,111,38,50,5,204,heavy
1185,0,22,Saturday,144,20,32,4,200,heavy
1186,0,22,Saturday,121,14,23,1,159,normal
1187,0,22,Saturday,136,36,40,4,216,heavy
1188,0,22,Saturday,114,21,23,1,159,normal
1189,0,22,Saturday,75,17,37,29,158,high
1190,0,22,Saturday,34,5,27,22,88,normal
1191,0,22,Saturday,45,6,7,15,73,normal
1192,0,22,Saturday,65,10,6,27,108,normal
1193,0,22,Saturday,67,25,20,18,130,normal
1194,0,22,Saturday,50,25,25,28,128,high
1195,0,22,Saturday,37,19,38,12,106,normal
1196,0,22,Saturday,36,8,3,29,76,normal
1197,0,22,Saturday,63,5,8,23,99,normal
1198,0,22,Saturday,67,5,7,22,101,normal
1199,0,22,Saturday,36,9,14,22,81,normal
1200,0,22,Saturday,57,8,10,22,97,normal
1201,0,22,Saturday,65,7,14,25,111,normal
1202,0,22,Saturday,54,10,3,29,96,normal
1203,0,22,Saturday,41,5,4,25,75,normal
1204,0,22,Saturday,43,9,3,25,80,normal
1205,0,22,Saturday,9,27,32,17,85,normal
1206,0,22,Saturday,101,28,18,20,167,normal
1207,0,22,Saturday,99,16,16,18,149,normal
1208,0,22,Saturday,20,27,32,12,91,normal
1209,0,22,Saturday,96,16,39,17,168,heavy
1210,0,22,Saturday,62,28,18,20,128,normal
1211,0,22,Saturday,58,27,17,5,107,normal
1212,0,22,Saturday,60,18,28,12,118,high
1213,0,22,Saturday,81,26,13,17,137,normal
1214,0,22,Saturday,118,15,27,13,173,heavy
1215,0,22,Saturday,53,12,25,20,110,normal
1216,0,22,Saturday,132,12,27,9,180,heavy
1217,0,22,Saturday,149,14,50,5,218,heavy
1218,0,22,Saturday,106,35,41,5,187,heavy
1219,0,22,Saturday,150,29,27,7,213,heavy
1220,0,22,Saturday,110,30,46,5,191,heavy
1221,0,22,Saturday,129,35,34,5,203,heavy
1222,0,22,Saturday,133,21,26,5,185,heavy
1223,0,22,Saturday,148,34,45,7,234,heavy
1224,0,22,Saturday,144,39,43,8,234,heavy
1225,0,22,Saturday,126,27,44,8,205,heavy
1226,0,22,Saturday,103,34,49,5,191,heavy
1227,0,22,Saturday,96,7,13,30,146,high
1228,0,22,Saturday,54,17,17,19,107,normal
1229,0,22,Saturday,98,16,17,15,146,normal
1230,0,22,Saturday,72,6,19,8,105,normal
1231,0,22,Saturday,69,23,12,31,135,high
1232,0,22,Saturday,85,13,16,24,138,high
1233,0,22,Saturday,102,22,12,9,145,normal
1234,0,22,Saturday,103,14,20,14,151,normal
1235,0,22,Saturday,80,12,10,22,124,high
1236,0,22,Saturday,63,18,11,5,97,low
1237,0,22,Saturday,84,21,13,9,127,normal
1238,0,22,Saturday,72,10,10,29,121,high
1239,0,22,Saturday,79,22,17,13,131,normal
1240,0,22,Saturday,12,5,0,27,44,normal
1241,0,22,Saturday,19,1,1,38,59,normal
1242,0,22,Saturday,14,3,0,33,50,normal
1243,0,22,Saturday,16,3,1,37,57,normal
1244,0,22,Saturday,14,5,0,37,56,normal
1245,0,22,Saturday,11,2,1,20,34,normal
1246,0,22,Saturday,20,3,0,25,48,normal
1247,0,22,Saturday,20,0,1,30,51,normal
1248,0,23,Monday,13,2,1,17,33,normal
1249,0,23,Monday,20,1,1,19,41,normal
1250,0,23,Monday,10,2,1,12,25,low
1251,0,23,Monday,14,2,0,25,41,normal
1252,0,23,Monday,12,0,1,16,29,normal
1253,0,23,Monday,11,5,1,31,48,normal
1254,0,23,Monday,13,1,1,16,31,normal
1255,0,23,Monday,17,3,0,10,30,low
1256,0,23,Monday,11,1,0,22,34,normal
1257,0,23,Monday,10,4,1,16,31,normal
1258,0,23,Monday,15,3,1,32,51,normal
1259,0,23,Monday,10,0,0,22,32,normal
1260,0,23,Monday,20,1,1,16,38,normal
1261,0,23,Monday,16,1,1,15,33,normal
1262,0,23,Monday,14,4,1,32,51,normal
1263,0,23,Monday,16,1,1,37,55,normal
1264,0,23,Monday,10,2,1,36,49,normal
1265,0,23,Monday,96,18,7,2,123,normal
1266,0,23,Monday,51,14,0,5,70,low
1267,0,23,Monday,63,25,2,8,98,low
1268,0,23,Monday,72,7,1,4,84,low
1269,0,23,Monday,86,18,6,1,111,low
1270,0,23,Monday,105,4,4,20,133,normal
1271,0,23,Monday,117,10,10,18,155,normal
1272,0,23,Monday,120,36,32,0,188,heavy
1273,0,23,Monday,135,20,31,0,186,heavy
1274,0,23,Monday,112,40,42,3,197,heavy
1275,0,23,Monday,135,13,20,3,171,heavy
1276,0,23,Monday,105,35,24,2,166,normal
1277,0,23,Monday,150,25,36,0,211,heavy
1278,0,23,Monday,108,27,23,2,160,normal
1279,0,23,Monday,108,40,45,1,194,heavy
1280,0,23,Monday,118,19,21,1,159,normal
1281,0,23,Monday,131,18,41,1,191,heavy
1282,0,23,Monday,148,31,20,4,203,heavy
1283,0,23,Monday,120,26,22,1,169,heavy
1284,0,23,Monday,147,12,32,0,191,heavy
1285,0,23,Monday,73,9,35,12,129,high
1286,0,23,Monday,93,21,22,29,165,high
1287,0,23,Monday,66,2,10,28,106,normal
1288,0,23,Monday,18,6,6,6,36,low
1289,0,23,Monday,78,1,16,30,125,high
1290,0,23,Monday,69,15,24,20,128,normal
1291,0,23,Monday,82,2,40,17,141,high
1292,0,23,Monday,57,9,5,23,94,normal
1293,0,23,Monday,25,5,14,26,70,normal
1294,0,23,Monday,40,9,15,28,92,normal
1295,0,23,Monday,52,6,13,21,92,normal
1296,0,23,Monday,45,8,13,29,95,normal
1297,0,23,Monday,67,10,7,25,109,normal
1298,0,23,Monday,20,8,14,30,72,normal
1299,0,23,Monday,44,8,4,29,85,normal
1300,0,23,Monday,63,5,8,29,105,normal
1301,0,23,Monday,119,15,20,13,167,normal
1302,0,23,Monday,103,10,23,7,143,normal
1303,0,23,Monday,42,14,15,14,85,normal
1304,0,23,Monday,67,20,24,12,123,normal
1305,0,23,Monday,56,18,29,17,120,high
1306,0,23,Monday,65,16,32,15,128,high
1307,0,23,Monday,107,11,26,19,163,high
1308,0,23,Monday,11,18,22,10,61,normal
1309,0,23,Monday,28,15,27,12,82,normal
1310,0,23,Monday,45,17,7,6,75,low
1311,0,23,Monday,66,12,27,6,111,normal
1312,0,23,Monday,104,40,22,9,175,heavy
1313,0,23,Monday,113,21,26,5,165,high
1314,0,23,Monday,120,29,37,6,192,heavy
1315,0,23,Monday,129,10,39,6,184,heavy
1316,0,23,Monday,119,29,40,10,198,heavy
1317,0,23,Monday,119,25,32,9,185,heavy
1318,0,23,Monday,123,10,30,7,170,heavy
1319,0,23,Monday,111,33,28,5,177,heavy
1320,0,23,Monday,110,12,47,8,177,heavy
1321,0,23,Monday,139,15,43,9,206,heavy
1322,0,23,Monday,132,29,25,7,193,heavy
1323,0,23,Monday,51,8,18,18,95,normal
1324,0,23,Monday,76,5,14,20,115,normal
1325,0,23,Monday,53,15,13,23,104,normal
1326,0,23,Monday,50,25,19,9,103,normal
1327,0,23,Monday,86,24,20,34,164,high
1328,0,23,Monday,67,23,14,13,117,normal
1329,0,23,Monday,54,9,15,7,85,low
1330,0,23,Monday,59,12,16,35,122,high
1331,0,23,Monday,109,25,15,5,154,normal
1332,0,23,Monday,73,18,10,35,136,high
1333,0,23,Monday,65,24,14,19,122,normal
1334,0,23,Monday,94,10,11,22,137,high
1335,0,23,Monday,106,9,12,31,158,high
1336,0,23,Monday,18,3,0,11,32,low
1337,0,23,Monday,17,1,1,36,55,normal
1338,0,23,Monday,12,0,0,22,34,normal
1339,0,23,Monday,11,1,0,19,31,normal
1340,0,23,Monday,16,1,0,32,49,normal
1341,0,23,Monday,12,3,1,13,29,normal
1342,0,23,Monday,14,4,1,27,46,normal
1343,0,23,Monday,11,3,1,37,52,normal
1344,0,24,Tuesday,17,2,0,18,37,normal
1345,0,24,Tuesday,18,4,1,39,62,normal
1346,0,24,Tuesday,20,4,0,32,56,normal
1347,0,24,Tuesday,15,0,0,28,43,normal
1348,0,24,Tuesday,11,4,0,12,27,low
1349,0,24,Tuesday,19,5,1,35,60,normal
1350,0,24,Tuesday,15,0,1,26,42,normal
1351,0,24,Tuesday,11,4,0,31,46,normal
1352,0,24,Tuesday,19,2,1,33,55,normal
1353,0,24,Tuesday,12,4,1,29,46,normal
1354,0,24,Tuesday,15,5,1,16,37,normal
1355,0,24,Tuesday,14,4,1,21,40,normal
1356,0,24,Tuesday,19,4,1,17,41,normal
1357,0,24,Tuesday,10,2,1,12,25,low
1358,0,24,Tuesday,10,0,0,11,21,low
1359,0,24,Tuesday,20,4,1,33,58,normal
1360,0,24,Tuesday,10,1,0,12,23,low
1361,0,24,Tuesday,73,12,5,5,95,low
1362,0,24,Tuesday,95,15,4,19,133,normal
1363,0,24,Tuesday,81,19,3,13,116,normal
1364,0,24,Tuesday,119,25,10,9,163,normal
1365,0,24,Tuesday,80,10,4,15,109,normal
1366,0,24,Tuesday,102,24,3,16,145,normal
1367,0,24,Tuesday,68,17,6,10,101,low
1368,0,24,Tuesday,109,40,38,0,187,heavy
1369,0,24,Tuesday,124,25,31,1,181,heavy
1370,0,24,Tuesday,126,22,21,1,170,heavy
1371,0,24,Tuesday,120,31,29,5,185,heavy
1372,0,24,Tuesday,101,20,47,5,173,heavy
1373,0,24,Tuesday,139,40,48,2,229,heavy
1374,0,24,Tuesday,116,23,23,4,166,normal
1375,0,24,Tuesday,101,14,24,0,139,normal
1376,0,24,Tuesday,137,40,21,5,203,heavy
1377,0,24,Tuesday,131,26,36,0,193,heavy
1378,0,24,Tuesday,114,27,45,4,190,heavy
1379,0,24,Tuesday,102,14,46,1,163,high
1380,0,24,Tuesday,116,24,32,5,177,heavy
1381,0,24,Tuesday,29,10,21,12,72,normal
1382,0,24,Tuesday,41,12,15,10,78,low
1383,0,24,Tuesday,41,9,7,27,84,normal
1384,0,24,Tuesday,90,25,26,10,151,high
1385,0,24,Tuesday,64,25,17,20,126,normal
1386,0,24,Tuesday,64,10,17,23,114,high
1387,0,24,Tuesday,69,17,5,28,119,high
1388,0,24,Tuesday,59,9,9,21,98,normal
1389,0,24,Tuesday,44,10,12,29,95,normal
1390,0,24,Tuesday,43,5,6,26,80,normal
1391,0,24,Tuesday,65,7,10,21,103,normal
1392,0,24,Tuesday,29,5,12,21,67,normal
1393,0,24,Tuesday,24,9,8,20,61,normal
1394,0,24,Tuesday,44,6,4,26,80,normal
1395,0,24,Tuesday,35,10,12,24,81,normal
1396,0,24,Tuesday,43,10,15,21,89,normal
1397,0,24,Tuesday,45,17,24,11,97,normal
1398,0,24,Tuesday,108,21,37,14,180,heavy
1399,0,24,Tuesday,53,19,33,9,114,high
1400,0,24,Tuesday,75,23,31,13,142,high
1401,0,24,Tuesday,70,18,5,19,112,normal
1402,0,24,Tuesday,52,25,15,19,111,normal
1403,0,24,Tuesday,9,18,24,9,60,normal
1404,0,24,Tuesday,47,21,9,18,95,normal
1405,0,24,Tuesday,116,20,17,19,172,heavy
1406,0,24,Tuesday,65,14,6,9,94,low
1407,0,24,Tuesday,93,12,13,13,131,normal
1408,0,24,Tuesday,100,21,45,9,175,heavy
1409,0,24,Tuesday,121,24,31,6,182,heavy
1410,0,24,Tuesday,110,15,50,5,180,heavy
1411,0,24,Tuesday,103,17,28,5,153,high
1412,0,24,Tuesday,136,38,20,5,199,heavy
1413,0,24,Tuesday,119,22,32,9,182,heavy
1414,0,24,Tuesday,132,17,36,5,190,heavy
1415,0,24,Tuesday,147,10,41,5,203,heavy
1416,0,24,Tuesday,111,12,44,6,173,heavy
1417,0,24,Tuesday,102,27,32,5,166,high
1418,0,24,Tuesday,137,25,29,7,198,heavy
1419,0,24,Tuesday,71,17,15,31,134,high
1420,0,24,Tuesday,64,25,11,15,115,normal
1421,0,24,Tuesday,70,16,15,29,130,high
1422,0,24,Tuesday,91,9,11,32,143,high
1423,0,24,Tuesday,95,6,11,35,147,high
1424,0,24,Tuesday,76,16,10,31,133,high
1425,0,24,Tuesday,87,17,18,7,129,normal
1426,0,24,Tuesday,63,22,12,29,126,high
1427,0,24,Tuesday,56,17,20,8,101,normal
1428,0,24,Tuesday,102,18,19,29,168,heavy
1429,0,24,Tuesday,60,23,10,13,106,normal
1430,0,24,Tuesday,88,6,18,25,137,high
1431,0,24,Tuesday,104,15,10,32,161,high
1432,0,24,Tuesday,16,1,1,26,44,normal
1433,0,24,Tuesday,12,1,0,12,25,low
1434,0,24,Tuesday,16,1,0,29,46,normal
1435,0,24,Tuesday,13,5,0,31,49,normal
1436,0,24,Tuesday,20,1,1,27,49,normal
1437,0,24,Tuesday,18,0,0,29,47,normal
1438,0,24,Tuesday,16,3,1,26,46,normal
1439,0,24,Tuesday,18,0,0,21,39,normal
1440,0,25,Wednesday,11,5,0,24,40,normal
1441,0,25,Wednesday,13,1,0,10,24,low
1442,0,25,Wednesday,10,1,0,26,37,normal
1443,0,25,Wednesday,19,5,1,22,47,normal
1444,0,25,Wednesday,20,0,0,10,30,low
1445,0,25,Wednesday,16,4,1,39,60,normal
1446,0,25,Wednesday,19,1,1,11,32,low
1447,0,25,Wednesday,20,4,0,38,62,normal
1448,0,25,Wednesday,15,1,1,15,32,normal
1449,0,25,Wednesday,10,0,0,33,43,normal
1450,0,25,Wednesday,20,5,0,24,49,normal
1451,0,25,Wednesday,12,2,1,35,50,normal
1452,0,25,Wednesday,10,4,1,37,52,normal
1453,0,25,Wednesday,15,4,0,38,57,normal
1454,0,25,Wednesday,19,0,1,39,59,normal
1455,0,25,Wednesday,16,4,0,35,55,normal
1456,0,25,Wednesday,20,3,1,35,59,normal
1457,0,25,Wednesday,118,1,0,4,123,normal
1458,0,25,Wednesday,89,20,4,17,130,normal
1459,0,25,Wednesday,120,18,6,13,157,normal
1460,0,25,Wednesday,85,7,3,18,113,normal
1461,0,25,Wednesday,99,8,2,14,123,normal
1462,0,25,Wednesday,59,25,2,7,93,low
1463,0,25,Wednesday,58,25,2,5,90,low
1464,0,25,Wednesday,113,40,36,4,193,heavy
1465,0,25,Wednesday,113,16,50,2,181,heavy
1466,0,25,Wednesday,121,27,50,4,202,heavy
1467,0,25,Wednesday,150,17,28,0,195,heavy
1468,0,25,Wednesday,136,29,23,0,188,heavy
1469,0,25,Wednesday,142,32,27,2,203,heavy
1470,0,25,Wednesday,106,32,42,2,182,heavy
1471,0,25,Wednesday,103,21,20,0,144,normal
1472,0,25,Wednesday,131,19,26,1,177,heavy
1473,0,25,Wednesday,133,23,21,3,180,heavy
1474,0,25,Wednesday,123,17,50,1,191,heavy
1475,0,25,Wednesday,124,21,35,2,182,heavy
1476,0,25,Wednesday,136,26,20,4,186,heavy
1477,0,25,Wednesday,92,10,39,19,160,high
1478,0,25,Wednesday,82,7,13,19,121,normal
1479,0,25,Wednesday,42,2,28,27,99,normal
1480,0,25,Wednesday,24,17,17,9,67,normal
1481,0,25,Wednesday,42,19,17,12,90,normal
1482,0,25,Wednesday,100,12,5,23,140,high
1483,0,25,Wednesday,11,25,30,22,88,normal
1484,0,25,Wednesday,27,7,10,22,66,normal
1485,0,25,Wednesday,38,7,11,20,76,normal
1486,0,25,Wednesday,49,10,6,27,92,normal
1487,0,25,Wednesday,66,9,7,28,110,normal
1488,0,25,Wednesday,70,8,3,22,103,normal
1489,0,25,Wednesday,58,7,6,27,98,normal
1490,0,25,Wednesday,53,9,13,29,104,normal
1491,0,25,Wednesday,22,5,6,26,59,normal
1492,0,25,Wednesday,40,10,11,28,89,normal
1493,0,25,Wednesday,58,13,10,12,93,low
1494,0,25,Wednesday,60,25,24,17,126,normal
1495,0,25,Wednesday,25,11,24,17,77,normal
1496,0,25,Wednesday,22,28,11,18,79,normal
1497,0,25,Wednesday,6,11,37,15,69,normal
1498,0,25,Wednesday,92,18,34,18,162,high
1499,0,25,Wednesday,97,17,38,20,172,heavy
1500,0,25,Wednesday,92,18,31,6,147,high
1501,0,25,Wednesday,74,12,17,16,119,normal
1502,0,25,Wednesday,67,22,7,5,101,low
1503,0,25,Wednesday,84,20,25,15,144,normal
1504,0,25,Wednesday,144,15,42,8,209,heavy
1505,0,25,Wednesday,120,11,47,7,185,heavy
1506,0,25,Wednesday,108,10,36,6,160,high
1507,0,25,Wednesday,141,13,50,6,210,heavy
1508,0,25,Wednesday,121,37,29,8,195,heavy
1509,0,25,Wednesday,142,40,22,6,210,heavy
1510,0,25,Wednesday,137,23,28,7,195,heavy
1511,0,25,Wednesday,117,10,27,8,162,high
1512,0,25,Wednesday,100,16,37,7,160,high
1513,0,25,Wednesday,148,11,42,8,209,heavy
1514,0,25,Wednesday,148,27,39,6,220,heavy
1515,0,25,Wednesday,65,18,20,21,124,high
1516,0,25,Wednesday,75,9,14,6,104,low
1517,0,25,Wednesday,85,15,20,29,149,high
1518,0,25,Wednesday,57,21,20,18,116,normal
1519,0,25,Wednesday,50,7,13,30,100,normal
1520,0,25,Wednesday,87,21,14,34,156,high
1521,0,25,Wednesday,64,24,11,6,105,low
1522,0,25,Wednesday,76,6,18,14,114,normal
1523,0,25,Wednesday,69,11,12,8,100,low
1524,0,25,Wednesday,76,9,17,14,116,normal
1525,0,25,Wednesday,94,8,15,5,122,normal
1526,0,25,Wednesday,104,10,16,33,163,high
1527,0,25,Wednesday,98,13,13,33,157,high
1528,0,25,Wednesday,13,5,0,18,36,normal
1529,0,25,Wednesday,17,1,0,11,29,low
1530,0,25,Wednesday,18,2,1,34,55,normal
1531,0,25,Wednesday,11,1,0,35,47,normal
1532,0,25,Wednesday,17,4,0,11,32,low
1533,0,25,Wednesday,17,1,1,23,42,normal
1534,0,25,Wednesday,17,2,0,23,42,normal
1535,0,25,Wednesday,16,4,1,30,51,normal
1536,0,26,Thursday,15,5,1,23,44,normal
1537,0,26,Thursday,18,0,0,31,49,normal
1538,0,26,Thursday,10,1,0,17,28,normal
1539,0,26,Thursday,13,2,0,32,47,normal
1540,0,26,Thursday,16,1,0,38,55,normal
1541,0,26,Thursday,11,4,0,32,47,normal
1542,0,26,Thursday,12,2,0,26,40,normal
1543,0,26,Thursday,14,2,1,14,31,normal
1544,0,26,Thursday,18,2,0,37,57,normal
1545,0,26,Thursday,17,1,1,22,41,normal
1546,0,26,Thursday,12,3,0,29,44,normal
1547,0,26,Thursday,20,5,0,30,55,normal
1548,0,26,Thursday,17,5,1,19,42,normal
1549,0,26,Thursday,12,0,1,33,46,normal
1550,0,26,Thursday,19,1,0,20,40,normal
1551,0,26,Thursday,11,4,1,38,54,normal
1552,0,26,Thursday,14,5,0,39,58,normal
1553,0,26,Thursday,102,20,4,12,138,normal
1554,0,26,Thursday,92,4,6,18,120,normal
1555,0,26,Thursday,54,14,10,16,94,normal
1556,0,26,Thursday,55,15,1,10,81,low
1557,0,26,Thursday,64,27,5,5,101,low
1558,0,26,Thursday,52,13,5,15,85,normal
1559,0,26,Thursday,73,11,4,3,91,low
1560,0,26,Thursday,106,27,45,5,183,heavy
1561,0,26,Thursday,145,21,40,5,211,heavy
1562,0,26,Thursday,133,19,28,5,185,heavy
1563,0,26,Thursday,117,31,49,0,197,heavy
1564,0,26,Thursday,146,17,34,0,197,heavy
1565,0,26,Thursday,101,35,42,3,181,heavy
1566,0,26,Thursday,103,28,32,1,164,high
1567,0,26,Thursday,150,10,26,0,186,heavy
1568,0,26,Thursday,135,23,48,0,206,heavy
1569,0,26,Thursday,104,10,48,2,164,high
1570,0,26,Thursday,144,39,50,1,234,heavy
1571,0,26,Thursday,132,10,49,0,191,heavy
1572,0,26,Thursday,142,19,31,1,193,heavy
1573,0,26,Thursday,45,4,30,29,108,normal
1574,0,26,Thursday,27,24,10,5,66,low
1575,0,26,Thursday,85,3,14,16,118,normal
1576,0,26,Thursday,84,11,27,26,148,high
1577,0,26,Thursday,90,4,10,20,124,normal
1578,0,26,Thursday,13,19,39,12,83,normal
1579,0,26,Thursday,11,1,37,9,58,normal
1580,0,26,Thursday,57,10,4,27,98,normal
1581,0,26,Thursday,52,10,9,23,94,normal
1582,0,26,Thursday,38,7,13,21,79,normal
1583,0,26,Thursday,35,7,15,24,81,normal
1584,0,26,Thursday,60,10,12,21,103,normal
1585,0,26,Thursday,70,10,3,30,113,high
1586,0,26,Thursday,34,8,6,30,78,normal
1587,0,26,Thursday,44,6,4,27,81,normal
1588,0,26,Thursday,21,5,4,25,55,normal
1589,0,26,Thursday,106,10,11,11,138,normal
1590,0,26,Thursday,82,30,32,10,154,high
1591,0,26,Thursday,57,12,9,17,95,normal
1592,0,26,Thursday,60,18,21,10,109,normal
1593,0,26,Thursday,79,17,34,8,138,high
1594,0,26,Thursday,78,29,22,13,142,normal
1595,0,26,Thursday,69,14,32,18,133,high
1596,0,26,Thursday,84,25,5,9,123,normal
1597,0,26,Thursday,62,11,28,5,106,normal
1598,0,26,Thursday,33,17,22,18,90,normal
1599,0,26,Thursday,14,21,23,6,64,normal
1600,0,26,Thursday,127,27,40,5,199,heavy
1601,0,26,Thursday,136,10,27,7,180,heavy
1602,0,26,Thursday,148,14,37,9,208,heavy
1603,0,26,Thursday,122,16,28,6,172,heavy
1604,0,26,Thursday,132,12,45,9,198,heavy
1605,0,26,Thursday,136,29,29,10,204,heavy
1606,0,26,Thursday,103,33,48,10,194,heavy
1607,0,26,Thursday,132,37,23,10,202,heavy
1608,0,26,Thursday,136,39,39,6,220,heavy
1609,0,26,Thursday,120,24,36,5,185,heavy
1610,0,26,Thursday,126,34,38,9,207,heavy
1611,0,26,Thursday,80,22,14,18,134,normal
1612,0,26,Thursday,99,9,15,29,152,high
1613,0,26,Thursday,81,21,19,7,128,normal
1614,0,26,Thursday,87,9,16,26,138,high
1615,0,26,Thursday,80,17,13,30,140,high
1616,0,26,Thursday,91,18,18,9,136,normal
1617,0,26,Thursday,90,19,15,13,137,normal
1618,0,26,Thursday,107,19,10,23,159,high
1619,0,26,Thursday,98,11,14,27,150,high
1620,0,26,Thursday,98,18,20,22,158,high
1621,0,26,Thursday,102,5,12,17,136,normal
1622,0,26,Thursday,62,13,16,28,119,high
1623,0,26,Thursday,101,15,12,35,163,high
1624,0,26,Thursday,17,5,1,16,39,normal
1625,0,26,Thursday,10,4,1,37,52,normal
1626,0,26,Thursday,16,4,0,35,55,normal
1627,0,26,Thursday,17,2,0,17,36,normal
1628,0,26,Thursday,17,0,0,27,44,normal
1629,0,26,Thursday,17,4,1,25,47,normal
1630,0,26,Thursday,15,2,0,15,32,normal
1631,0,26,Thursday,20,0,1,12,33,low
1632,0,27,Friday,16,3,0,28,47,normal
1633,0,27,Friday,13,2,1,28,44,normal
1634,0,27,Friday,15,5,0,26,46,normal
1635,0,27,Friday,15,2,1,16,34,normal
1636,0,27,Friday,12,3,0,26,41,normal
1637,0,27,Friday,15,5,0,27,47,normal
1638,0,27,Friday,20,2,0,17,39,normal
1639,0,27,Friday,12,2,0,16,30,normal
1640,0,27,Friday,19,1,0,38,58,normal
1641,0,27,Friday,16,1,1,32,50,normal
1642,0,27,Friday,12,0,0,11,23,low
1643,0,27,Friday,16,5,1,29,51,normal
1644,0,27,Friday,19,5,1,18,43,normal
1645,0,27,Friday,11,0,0,15,26,normal
1646,0,27,Friday,15,4,1,17,37,normal
1647,0,27,Friday,20,1,0,23,44,normal
1648,0,27,Friday,10,4,0,36,50,normal
1649,0,27,Friday,39,14,0,15,68,normal
1650,0,27,Friday,33,7,3,10,53,low
1651,0,27,Friday,77,8,7,15,107,normal
1652,0,27,Friday,80,18,6,11,115,normal
1653,0,27,Friday,53,11,7,15,86,normal
1654,0,27,Friday,73,17,6,13,109,normal
1655,0,27,Friday,77,20,4,13,114,normal
1656,0,27,Friday,76,14,1,12,103,low
1657,0,27,Friday,58,14,0,15,87,normal
1658,0,27,Friday,57,18,7,13,95,normal
1659,0,27,Friday,80,16,0,10,106,low
1660,0,27,Friday,38,7,1,13,59,normal
1661,0,27,Friday,53,20,6,12,91,low
1662,0,27,Friday,30,9,7,10,56,low
1663,0,27,Friday,50,19,4,10,83,low
1664,0,27,Friday,31,14,3,14,62,normal
1665,0,27,Friday,28,18,5,10,61,low
1666,0,27,Friday,31,15,4,12,62,low
1667,0,27,Friday,52,19,0,10,81,low
1668,0,27,Friday,42,9,2,13,66,normal
1669,0,27,Friday,151,55,27,2,235,heavy
1670,0,27,Friday,180,69,29,1,279,heavy
1671,0,27,Friday,149,41,23,3,216,heavy
1672,0,27,Friday,167,60,27,3,257,heavy
1673,0,27,Friday,134,45,22,3,204,heavy
1674,0,27,Friday,180,62,26,4,272,heavy
1675,0,27,Friday,156,54,25,3,238,heavy
1676,0,27,Friday,171,60,18,1,250,heavy
1677,0,27,Friday,174,53,10,3,240,heavy
1678,0,27,Friday,154,61,16,3,234,heavy
1679,0,27,Friday,161,53,11,1,226,heavy
1680,0,27,Friday,148,48,13,2,211,heavy
1681,0,27,Friday,136,60,27,2,225,heavy
1682,0,27,Friday,143,68,16,0,227,heavy
1683,0,27,Friday,152,51,22,2,227,heavy
1684,0,27,Friday,132,58,15,4,209,heavy
1685,0,27,Friday,155,58,15,4,232,heavy
1686,0,27,Friday,144,62,12,3,221,heavy
1687,0,27,Friday,161,51,20,1,233,heavy
1688,0,27,Friday,137,46,13,2,198,heavy
1689,0,27,Friday,149,61,16,1,227,heavy
1690,0,27,Friday,158,46,20,1,225,heavy
1691,0,27,Friday,134,65,22,0,221,heavy
1692,0,27,Friday,134,65,10,2,211,heavy
1693,0,27,Friday,73,24,4,0,101,low
1694,0,27,Friday,64,23,21,1,109,normal
1695,0,27,Friday,51,27,25,2,105,normal
1696,0,27,Friday,80,22,17,0,119,normal
1697,0,27,Friday,61,26,8,0,95,low
1698,0,27,Friday,75,24,8,0,107,low
1699,0,27,Friday,82,20,15,2,119,normal
1700,0,27,Friday,53,28,21,1,103,normal
1701,0,27,Friday,68,29,14,0,111,low
1702,0,27,Friday,63,28,22,0,113,normal
1703,0,27,Friday,76,30,20,1,127,normal
1704,0,27,Friday,66,23,10,0,99,low
1705,0,27,Friday,50,23,1,0,74,low
1706,0,27,Friday,60,29,22,2,113,normal
1707,0,27,Friday,75,26,11,0,112,normal
1708,0,27,Friday,81,22,18,2,123,normal
1709,0,27,Friday,33,6,0,4,43,low
1710,0,27,Friday,21,5,6,15,47,normal
1711,0,27,Friday,22,7,1,2,32,low
1712,0,27,Friday,31,6,0,15,52,normal
1713,0,27,Friday,41,8,3,2,54,low
1714,0,27,Friday,24,6,5,11,46,low
1715,0,27,Friday,45,6,6,10,67,low
1716,0,27,Friday,24,11,6,2,43,low
1717,0,27,Friday,47,6,2,12,67,low
1718,0,27,Friday,46,1,1,4,52,low
1719,0,27,Friday,26,3,2,3,34,low
1720,0,27,Friday,20,4,0,39,63,normal
1721,0,27,Friday,20,1,1,27,49,normal
1722,0,27,Friday,19,0,1,17,37,normal
1723,0,27,Friday,11,3,1,19,34,normal
1724,0,27,Friday,17,5,1,31,54,normal
1725,0,27,Friday,19,4,0,12,35,low
1726,0,27,Friday,11,1,0,38,50,normal
1727,0,27,Friday,12,0,0,17,29,normal
1728,0,28,Saturday,18,0,0,27,45,normal
1729,0,28,Saturday,19,4,0,14,37,normal
1730,0,28,Saturday,13,2,0,28,43,normal
1731,0,28,Saturday,18,4,1,23,46,normal
1732,0,28,Saturday,20,0,0,11,31,low
1733,0,28,Saturday,11,4,1,22,38,normal
1734,0,28,Saturday,15,2,0,18,35,normal
1735,0,28,Saturday,16,3,0,34,53,normal
1736,0,28,Saturday,11,2,0,18,31,normal
1737,0,28,Saturday,17,4,1,38,60,normal
1738,0,28,Saturday,20,4,1,28,53,normal
1739,0,28,Saturday,19,0,1,37,57,normal
1740,0,28,Saturday,10,2,1,34,47,normal
1741,0,28,Saturday,19,0,0,17,36,normal
1742,0,28,Saturday,15,0,0,30,45,normal
1743,0,28,Saturday,10,2,0,31,43,normal
1744,0,28,Saturday,18,3,0,17,38,normal
1745,0,28,Saturday,97,22,4,18,141,normal
1746,0,28,Saturday,111,12,9,17,149,normal
1747,0,28,Saturday,108,10,5,17,140,normal
1748,0,28,Saturday,74,24,10,20,128,normal
1749,0,28,Saturday,114,4,8,20,146,normal
1750,0,28,Saturday,91,16,5,11,123,normal
1751,0,28,Saturday,66,3,9,19,97,normal
1752,0,28,Saturday,104,32,23,5,164,normal
1753,0,28,Saturday,128,18,31,3,180,heavy
1754,0,28,Saturday,127,24,27,0,178,heavy
1755,0,28,Saturday,130,31,22,0,183,heavy
1756,0,28,Saturday,108,13,38,1,160,high
1757,0,28,Saturday,116,22,37,2,177,heavy
1758,0,28,Saturday,143,28,27,4,202,heavy
1759,0,28,Saturday,118,32,21,5,176,heavy
1760,0,28,Saturday,121,35,32,0,188,heavy
1761,0,28,Saturday,109,28,39,2,178,heavy
1762,0,28,Saturday,135,11,23,5,174,heavy
1763,0,28,Saturday,100,30,29,2,161,high
1764,0,28,Saturday,138,32,26,4,200,heavy
1765,0,28,Saturday,29,9,21,23,82,normal
1766,0,28,Saturday,36,17,7,30,90,normal
1767,0,28,Saturday,42,9,37,28,116,high
1768,0,28,Saturday,80,6,12,6,104,low
1769,0,28,Saturday,37,21,28,6,92,normal
1770,0,28,Saturday,44,17,27,30,118,high
1771,0,28,Saturday,25,12,13,5,55,low
1772,0,28,Saturday,36,9,9,30,84,normal
1773,0,28,Saturday,63,7,10,29,109,normal
1774,0,28,Saturday,20,5,13,22,60,normal
1775,0,28,Saturday,53,8,6,23,90,normal
1776,0,28,Saturday,41,7,5,26,79,normal
1777,0,28,Saturday,36,9,13,29,87,normal
1778,0,28,Saturday,65,10,8,22,105,normal
1779,0,28,Saturday,55,6,5,27,93,normal
1780,0,28,Saturday,63,8,15,30,116,high
1781,0,28,Saturday,19,26,32,18,95,normal
1782,0,28,Saturday,84,11,11,9,115,normal
1783,0,28,Saturday,110,23,34,9,176,heavy
1784,0,28,Saturday,46,20,18,5,89,normal
1785,0,28,Saturday,67,12,10,20,109,normal
1786,0,28,Saturday,42,25,20,19,106,normal
1787,0,28,Saturday,87,17,18,6,128,normal
1788,0,28,Saturday,45,24,31,11,111,normal
1789,0,28,Saturday,80,26,35,6,147,high
1790,0,28,Saturday,83,18,6,15,122,normal
1791,0,28,Saturday,68,19,15,11,113,normal
1792,0,28,Saturday,101,37,48,9,195,heavy
1793,0,28,Saturday,149,32,29,10,220,heavy
1794,0,28,Saturday,136,21,33,9,199,heavy
1795,0,28,Saturday,105,20,23,7,155,normal
1796,0,28,Saturday,125,12,20,8,165,normal
1797,0,28,Saturday,125,14,26,5,170,heavy
1798,0,28,Saturday,118,28,23,8,177,heavy
1799,0,28,Saturday,114,32,45,6,197,heavy
1800,0,28,Saturday,123,37,46,8,214,heavy
1801,0,28,Saturday,115,23,22,7,167,normal
1802,0,28,Saturday,111,25,35,10,181,heavy
1803,0,28,Saturday,66,8,11,9,94,low
1804,0,28,Saturday,103,12,17,23,155,high
1805,0,28,Saturday,94,14,14,24,146,high
1806,0,28,Saturday,105,23,15,18,161,normal
1807,0,28,Saturday,53,22,14,35,124,high
1808,0,28,Saturday,74,10,12,32,128,high
1809,0,28,Saturday,71,24,15,26,136,high
1810,0,28,Saturday,61,21,15,32,129,high
1811,0,28,Saturday,101,25,18,8,152,normal
1812,0,28,Saturday,104,22,10,14,150,normal
1813,0,28,Saturday,79,20,15,18,132,normal
1814,0,28,Saturday,70,20,11,14,115,normal
1815,0,28,Saturday,74,16,14,34,138,high
1816,0,28,Saturday,20,5,0,21,46,normal
1817,0,28,Saturday,16,0,0,36,52,normal
1818,0,28,Saturday,14,3,0,20,37,normal
1819,0,28,Saturday,14,1,1,30,46,normal
1820,0,28,Saturday,17,0,1,12,30,low
1821,0,28,Saturday,14,0,0,14,28,normal
1822,0,28,Saturday,18,5,0,40,63,normal
1823,0,28,Saturday,17,2,0,18,37,normal
1824,0,29,Sunday,14,1,1,35,51,normal
1825,0,29,Sunday,14,2,1,26,43,normal
1826,0,29,Sunday,16,0,1,37,54,normal
1827,0,29,Sunday,14,4,1,32,51,normal
1828,0,29,Sunday,19,5,0,12,36,low
1829,0,29,Sunday,11,0,1,31,43,normal
1830,0,29,Sunday,12,0,0,32,44,normal
1831,0,29,Sunday,12,3,0,32,47,normal
1832,0,29,Sunday,18,4,1,31,54,normal
1833,0,29,Sunday,17,4,1,20,42,normal
1834,0,29,Sunday,17,0,0,22,39,normal
1835,0,29,Sunday,19,2,1,12,34,low
1836,0,29,Sunday,18,2,1,19,40,normal
1837,0,29,Sunday,19,5,0,26,50,normal
1838,0,29,Sunday,19,5,1,35,60,normal
1839,0,29,Sunday,18,0,0,20,38,normal
1840,0,29,Sunday,16,0,0,30,46,normal
1841,0,29,Sunday,114,30,9,7,160,normal
1842,0,29,Sunday,102,17,2,14,135,normal
1843,0,29,Sunday,55,4,7,13,79,normal
1844,0,29,Sunday,82,2,4,14,102,normal
1845,0,29,Sunday,66,16,9,19,110,normal
1846,0,29,Sunday,86,5,1,13,105,normal
1847,0,29,Sunday,108,24,2,19,153,normal
1848,0,29,Sunday,112,30,26,0,168,heavy
1849,0,29,Sunday,147,31,46,0,224,heavy
1850,0,29,Sunday,116,20,40,2,178,heavy
1851,0,29,Sunday,138,13,21,5,177,heavy
1852,0,29,Sunday,132,25,40,2,199,heavy
1853,0,29,Sunday,124,14,31,4,173,heavy
1854,0,29,Sunday,106,27,25,1,159,normal
1855,0,29,Sunday,104,24,29,5,162,high
1856,0,29,Sunday,140,31,21,4,196,heavy
1857,0,29,Sunday,121,35,37,3,196,heavy
1858,0,29,Sunday,135,23,37,5,200,heavy
1859,0,29,Sunday,149,20,30,5,204,heavy
1860,0,29,Sunday,117,14,39,0,170,heavy
1861,0,29,Sunday,39,8,23,13,83,normal
1862,0,29,Sunday,40,14,18,21,93,normal
1863,0,29,Sunday,49,1,35,18,103,normal
1864,0,29,Sunday,38,12,35,25,110,normal
1865,0,29,Sunday,26,15,25,6,72,normal
1866,0,29,Sunday,93,14,10,25,142,high
1867,0,29,Sunday,54,24,37,20,135,high
1868,0,29,Sunday,32,6,10,23,71,normal
1869,0,29,Sunday,43,7,12,23,85,normal
1870,0,29,Sunday,23,6,15,20,64,normal
1871,0,29,Sunday,26,5,8,25,64,normal
1872,0,29,Sunday,55,7,8,27,97,normal
1873,0,29,Sunday,70,10,8,25,113,high
1874,0,29,Sunday,66,10,3,29,108,normal
1875,0,29,Sunday,66,7,15,26,114,high
1876,0,29,Sunday,46,6,7,21,80,normal
1877,0,29,Sunday,47,26,6,20,99,normal
1878,0,29,Sunday,75,20,7,11,113,normal
1879,0,29,Sunday,76,29,15,19,139,normal
1880,0,29,Sunday,56,14,38,12,120,high
1881,0,29,Sunday,19,26,36,17,98,normal
1882,0,29,Sunday,29,18,10,9,66,low
1883,0,29,Sunday,15,12,18,15,60,normal
1884,0,29,Sunday,53,27,27,17,124,high
1885,0,29,Sunday,95,22,28,9,154,high
1886,0,29,Sunday,27,27,32,10,96,normal
1887,0,29,Sunday,68,28,31,15,142,high
1888,0,29,Sunday,120,14,25,8,167,normal
1889,0,29,Sunday,144,28,24,8,204,heavy
1890,0,29,Sunday,112,31,43,8,194,heavy
1891,0,29,Sunday,149,28,20,10,207,heavy
1892,0,29,Sunday,131,29,34,8,202,heavy
1893,0,29,Sunday,104,31,41,9,185,heavy
1894,0,29,Sunday,141,30,27,7,205,heavy
1895,0,29,Sunday,117,10,47,9,183,heavy
1896,0,29,Sunday,112,13,37,6,168,heavy
1897,0,29,Sunday,127,40,39,8,214,heavy
1898,0,29,Sunday,131,15,31,6,183,heavy
1899,0,29,Sunday,66,8,10,11,95,low
1900,0,29,Sunday,61,23,18,34,136,high
1901,0,29,Sunday,55,25,13,26,119,high
1902,0,29,Sunday,85,23,20,6,134,normal
1903,0,29,Sunday,75,20,19,19,133,normal
1904,0,29,Sunday,58,17,20,22,117,high
1905,0,29,Sunday,60,23,11,26,120,high
1906,0,29,Sunday,80,21,11,7,119,normal
1907,0,29,Sunday,74,9,14,35,132,high
1908,0,29,Sunday,57,14,11,16,98,normal
1909,0,29,Sunday,73,9,13,5,100,low
1910,0,29,Sunday,80,25,19,26,150,high
1911,0,29,Sunday,82,13,12,21,128,high
1912,0,29,Sunday,15,4,0,27,46,normal
1913,0,29,Sunday,20,2,0,29,51,normal
1914,0,29,Sunday,12,2,0,39,53,normal
1915,0,29,Sunday,10,4,1,13,28,normal
1916,0,29,Sunday,16,0,1,29,46,normal
1917,0,29,Sunday,18,0,0,34,52,normal
1918,0,29,Sunday,11,5,1,19,36,normal
1919,0,29,Sunday,16,1,0,12,29,low
1920,0,30,Monday,13,3,1,12,29,low
1921,0,30,Monday,19,2,0,22,43,normal
1922,0,30,Monday,13,3,0,39,55,normal
1923,0,30,Monday,12,0,0,24,36,normal
1924,0,30,Monday,10,3,1,12,26,low
1925,0,30,Monday,11,4,0,38,53,normal
1926,0,30,Monday,18,4,0,31,53,normal
1927,0,30,Monday,19,1,0,34,54,normal
1928,0,30,Monday,18,1,0,27,46,normal
1929,0,30,Monday,13,0,0,26,39,normal
1930,0,30,Monday,12,2,0,35,49,normal
1931,0,30,Monday,15,4,0,12,31,low
1932,0,30,Monday,10,5,0,33,48,normal
1933,0,30,Monday,14,0,0,15,29,normal
1934,0,30,Monday,16,0,0,16,32,normal
1935,0,30,Monday,15,3,1,26,45,normal
1936,0,30,Monday,20,4,0,34,58,normal
1937,0,30,Monday,82,20,10,11,123,normal
1938,0,30,Monday,99,7,3,6,115,normal
1939,0,30,Monday,74,29,9,4,116,normal
1940,0,30,Monday,94,1,1,14,110,normal
1941,0,30,Monday,63,12,10,17,102,normal
1942,0,30,Monday,101,4,3,12,120,normal
1943,0,30,Monday,106,9,3,10,128,normal
1944,0,30,Monday,112,15,24,1,152,normal
1945,0,30,Monday,148,26,25,0,199,heavy
1946,0,30,Monday,115,20,31,3,169,heavy
1947,0,30,Monday,125,11,24,0,160,normal
1948,0,30,Monday,140,38,38,0,216,heavy
1949,0,30,Monday,150,17,35,5,207,heavy
1950,0,30,Monday,149,11,42,2,204,heavy
1951,0,30,Monday,150,22,38,3,213,heavy
1952,0,30,Monday,147,32,25,4,208,heavy
1953,0,30,Monday,138,39,45,4,226,heavy
1954,0,30,Monday,149,16,49,1,215,heavy
1955,0,30,Monday,139,10,50,2,201,heavy
1956,0,30,Monday,109,25,49,2,185,heavy
1957,0,30,Monday,84,24,12,28,148,high
1958,0,30,Monday,38,8,6,5,57,low
1959,0,30,Monday,45,16,6,21,88,normal
1960,0,30,Monday,57,4,36,14,111,normal
1961,0,30,Monday,84,12,6,28,130,high
1962,0,30,Monday,55,25,33,21,134,high
1963,0,30,Monday,14,15,5,21,55,normal
1964,0,30,Monday,26,8,11,20,65,normal
1965,0,30,Monday,60,10,9,27,106,normal
1966,0,30,Monday,34,6,7,25,72,normal
1967,0,30,Monday,22,9,8,26,65,normal
1968,0,30,Monday,59,10,11,30,110,normal
1969,0,30,Monday,48,6,14,28,96,normal
1970,0,30,Monday,46,9,11,23,89,normal
1971,0,30,Monday,37,9,8,20,74,normal
1972,0,30,Monday,67,9,11,21,108,normal
1973,0,30,Monday,32,19,39,9,99,normal
1974,0,30,Monday,63,12,22,5,102,normal
1975,0,30,Monday,32,29,25,11,97,normal
1976,0,30,Monday,83,22,40,20,165,high
1977,0,30,Monday,40,14,31,19,104,normal
1978,0,30,Monday,101,22,39,19,181,heavy
1979,0,30,Monday,62,29,31,11,133,high
1980,0,30,Monday,20,19,25,8,72,normal
1981,0,30,Monday,42,22,5,9,78,low
1982,0,30,Monday,37,17,12,16,82,normal
1983,0,30,Monday,95,12,20,15,142,normal
1984,0,30,Monday,137,14,41,10,202,heavy
1985,0,30,Monday,122,21,20,10,173,heavy
1986,0,30,Monday,104,19,39,9,171,heavy
1987,0,30,Monday,147,21,40,9,217,heavy
1988,0,30,Monday,105,38,34,7,184,heavy
1989,0,30,Monday,124,23,46,5,198,heavy
1990,0,30,Monday,135,18,20,5,178,heavy
1991,0,30,Monday,107,35,23,8,173,heavy
1992,0,30,Monday,109,21,24,10,164,normal
1993,0,30,Monday,136,32,26,8,202,heavy
1994,0,30,Monday,134,23,49,8,214,heavy
1995,0,30,Monday,90,20,11,25,146,high
1996,0,30,Monday,104,5,16,16,141,normal
1997,0,30,Monday,60,21,13,6,100,low
1998,0,30,Monday,104,22,11,13,150,normal
1999,0,30,Monday,54,23,10,25,112,high
2000,0,30,Monday,68,6,15,34,123,high
2001,0,30,Monday,88,13,19,19,139,normal
2002,0,30,Monday,64,22,16,16,118,normal
2003,0,30,Monday,58,24,14,24,120,high
2004,0,30,Monday,67,19,12,9,107,low
2005,0,30,Monday,73,20,18,7,118,normal
2006,0,30,Monday,109,25,16,20,170,heavy
2007,0,30,Monday,63,15,11,23,112,high
2008,0,30,Monday,19,4,1,26,50,normal
2009,0,30,Monday,15,1,0,34,50,normal
2010,0,30,Monday,15,5,1,14,35,normal
2011,0,30,Monday,19,3,1,33,56,normal
2012,0,30,Monday,18,4,0,11,33,low
2013,0,30,Monday,14,1,0,27,42,normal
2014,0,30,Monday,19,0,0,37,56,normal
2015,0,30,Monday,19,0,0,29,48,normal
2016,0,31,Tuesday,18,1,0,30,49,normal
2017,0,31,Tuesday,19,3,0,18,40,normal
2018,0,31,Tuesday,15,2,1,34,52,normal
2019,0,31,Tuesday,17,0,1,14,32,normal
2020,0,31,Tuesday,12,0,0,33,45,normal
2021,0,31,Tuesday,20,0,1,20,41,normal
2022,0,31,Tuesday,10,2,0,18,30,normal
2023,0,31,Tuesday,13,3,0,31,47,normal
2024,0,31,Tuesday,10,0,1,38,49,normal
2025,0,31,Tuesday,19,1,1,28,49,normal
2026,0,31,Tuesday,19,4,0,16,39,normal
2027,0,31,Tuesday,16,1,0,15,32,normal
2028,0,31,Tuesday,17,1,0,34,52,normal
2029,0,31,Tuesday,19,1,0,21,41,normal
2030,0,31,Tuesday,10,1,0,39,50,normal
2031,0,31,Tuesday,16,4,0,15,35,normal
2032,0,31,Tuesday,13,0,0,16,29,normal
2033,0,31,Tuesday,98,5,1,17,121,normal
2034,0,31,Tuesday,65,10,3,8,86,low
2035,0,31,Tuesday,98,17,0,20,135,normal
2036,0,31,Tuesday,60,20,5,6,91,low
2037,0,31,Tuesday,110,18,10,11,149,normal
2038,0,31,Tuesday,70,13,4,13,100,normal
2039,0,31,Tuesday,96,12,7,17,132,normal
2040,0,31,Tuesday,129,31,36,1,197,heavy
2041,0,31,Tuesday,146,28,47,3,224,heavy
2042,0,31,Tuesday,137,23,27,0,187,heavy
2043,0,31,Tuesday,131,28,24,0,183,heavy
2044,0,31,Tuesday,134,10,44,0,188,heavy
2045,0,31,Tuesday,109,25,24,0,158,normal
2046,0,31,Tuesday,108,35,22,3,168,heavy
2047,0,31,Tuesday,146,14,37,2,199,heavy
2048,0,31,Tuesday,147,21,41,5,214,heavy
2049,0,31,Tuesday,110,34,35,0,179,heavy
2050,0,31,Tuesday,110,40,50,2,202,heavy
2051,0,31,Tuesday,123,12,22,3,160,normal
2052,0,31,Tuesday,145,25,20,5,195,heavy
2053,0,31,Tuesday,82,15,16,29,142,high
2054,0,31,Tuesday,62,2,7,22,93,normal
2055,0,31,Tuesday,92,8,11,21,132,high
2056,0,31,Tuesday,35,22,22,18,97,normal
2057,0,31,Tuesday,66,25,13,13,117,normal
2058,0,31,Tuesday,50,2,25,12,89,normal
2059,0,31,Tuesday,50,22,24,7,103,normal
2060,0,31,Tuesday,50,8,5,24,87,normal
2061,0,31,Tuesday,55,5,5,21,86,normal
2062,0,31,Tuesday,51,10,14,24,99,normal
2063,0,31,Tuesday,34,8,14,21,77,normal
2064,0,31,Tuesday,25,7,5,20,57,normal
2065,0,31,Tuesday,59,7,9,21,96,normal
2066,0,31,Tuesday,38,10,9,24,81,normal
2067,0,31,Tuesday,70,10,9,23,112,high
2068,0,31,Tuesday,63,8,13,22,106,normal
2069,0,31,Tuesday,6,24,12,13,55,normal
2070,0,31,Tuesday,108,17,16,16,157,normal
2071,0,31,Tuesday,41,20,32,12,105,normal
2072,0,31,Tuesday,54,10,20,9,93,normal
2073,0,31,Tuesday,60,19,14,7,100,low
2074,0,31,Tuesday,102,11,9,11,133,normal
2075,0,31,Tuesday,50,24,30,5,109,normal
2076,0,31,Tuesday,25,24,19,10,78,normal
2077,0,31,Tuesday,90,25,18,20,153,normal
2078,0,31,Tuesday,86,13,27,11,137,high
2079,0,31,Tuesday,44,19,17,9,89,normal
2080,0,31,Tuesday,126,24,35,8,193,heavy
2081,0,31,Tuesday,146,26,42,9,223,normal
2082,0,31,Tuesday,117,28,33,10,188,heavy
2083,0,31,Tuesday,144,36,49,10,239,heavy
2084,0,31,Tuesday,137,19,23,9,188,heavy
2085,0,31,Tuesday,118,19,48,5,190,heavy
2086,0,31,Tuesday,119,27,28,8,182,heavy
2087,0,31,Tuesday,149,26,43,5,223,normal
2088,0,31,Tuesday,117,34,36,10,197,heavy
2089,0,31,Tuesday,124,30,44,10,208,heavy
2090,0,31,Tuesday,141,36,48,5,230,heavy
2091,0,31,Tuesday,78,6,11,28,123,high
2092,0,31,Tuesday,102,23,16,24,165,high
2093,0,31,Tuesday,104,18,18,23,163,high
2094,0,31,Tuesday,95,9,19,7,130,normal
2095,0,31,Tuesday,105,13,12,20,150,normal
2096,0,31,Tuesday,100,18,16,34,168,heavy
2097,0,31,Tuesday,80,14,20,15,129,normal
2098,0,31,Tuesday,86,8,19,7,120,normal
2099,0,31,Tuesday,108,20,14,15,157,normal
2100,0,31,Tuesday,69,13,13,8,103,low
2101,0,31,Tuesday,64,14,10,6,94,low
2102,0,31,Tuesday,71,14,17,10,112,normal
2103,0,31,Tuesday,61,9,18,24,112,high
2104,0,31,Tuesday,11,4,0,31,46,normal
2105,0,31,Tuesday,17,5,0,14,36,normal
2106,0,31,Tuesday,15,5,0,18,38,normal
2107,0,31,Tuesday,14,2,0,40,56,normal
2108,0,31,Tuesday,12,2,1,28,43,normal
2109,0,31,Tuesday,18,0,1,40,59,normal
2110,0,31,Tuesday,14,5,0,13,32,normal
2111,0,31,Tuesday,18,1,0,26,45,normal
2112,0,1,Wednesday,14,0,0,34,48,normal
2113,0,1,Wednesday,17,5,0,23,45,normal
2114,0,1,Wednesday,19,1,1,18,39,normal
2115,0,1,Wednesday,15,5,1,12,33,low
2116,0,1,Wednesday,13,2,1,26,42,normal
2117,0,1,Wednesday,15,3,0,32,50,normal
2118,0,1,Wednesday,15,0,1,13,29,normal
2119,0,1,Wednesday,18,5,1,12,36,low
2120,0,1,Wednesday,17,1,0,29,47,normal
2121,0,1,Wednesday,10,4,0,19,33,normal
2122,0,1,Wednesday,15,0,0,18,33,normal
2123,0,1,Wednesday,11,0,0,35,46,normal
2124,0,1,Wednesday,20,5,1,34,60,normal
2125,0,1,Wednesday,15,5,1,32,53,normal
2126,0,1,Wednesday,16,4,1,37,58,normal
2127,0,1,Wednesday,14,1,0,12,27,low
2128,0,1,Wednesday,16,4,0,18,38,normal
2129,0,1,Wednesday,56,21,3,0,80,low
2130,0,1,Wednesday,78,11,10,18,117,normal
2131,0,1,Wednesday,82,29,0,20,131,normal
2132,0,1,Wednesday,102,15,2,7,126,normal
2133,0,1,Wednesday,69,14,6,18,107,normal
2134,0,1,Wednesday,87,24,6,19,136,normal
2135,0,1,Wednesday,84,16,10,5,115,normal
2136,0,1,Wednesday,109,38,34,5,186,heavy
2137,0,1,Wednesday,147,38,23,3,211,heavy
2138,0,1,Wednesday,135,19,48,5,207,heavy
2139,0,1,Wednesday,101,23,41,5,170,heavy
2140,0,1,Wednesday,138,21,28,1,188,heavy
2141,0,1,Wednesday,136,20,32,1,189,heavy
2142,0,1,Wednesday,123,19,25,5,172,heavy
2143,0,1,Wednesday,108,30,46,5,189,heavy
2144,0,1,Wednesday,128,15,43,5,191,heavy
2145,0,1,Wednesday,129,37,41,1,208,heavy
2146,0,1,Wednesday,127,18,28,3,176,heavy
2147,0,1,Wednesday,142,37,46,3,228,heavy
2148,0,1,Wednesday,149,26,46,1,222,heavy
2149,0,1,Wednesday,77,13,7,23,120,high
2150,0,1,Wednesday,37,16,13,29,95,normal
2151,0,1,Wednesday,79,8,16,12,115,normal
2152,0,1,Wednesday,97,2,16,7,122,normal
2153,0,1,Wednesday,22,8,31,8,69,normal
2154,0,1,Wednesday,31,23,19,12,85,normal
2155,0,1,Wednesday,49,22,16,5,92,normal
2156,0,1,Wednesday,32,5,3,21,61,normal
2157,0,1,Wednesday,40,6,11,28,85,normal
2158,0,1,Wednesday,42,6,10,21,79,normal
2159,0,1,Wednesday,37,9,7,25,78,normal
2160,0,1,Wednesday,45,5,5,24,79,normal
2161,0,1,Wednesday,64,10,4,28,106,normal
2162,0,1,Wednesday,33,8,6,23,70,normal
2163,0,1,Wednesday,34,6,12,27,79,normal
2164,0,1,Wednesday,40,9,5,20,74,normal
2165,0,1,Wednesday,64,19,22,12,117,normal
2166,0,1,Wednesday,108,24,34,7,173,heavy
2167,0,1,Wednesday,108,17,33,7,165,high
2168,0,1,Wednesday,50,23,21,11,105,normal
2169,0,1,Wednesday,16,21,10,16,63,normal
2170,0,1,Wednesday,91,22,34,8,155,high
2171,0,1,Wednesday,89,19,37,18,163,high
2172,0,1,Wednesday,108,12,23,8,151,normal
2173,0,1,Wednesday,73,29,23,7,132,normal
2174,0,1,Wednesday,76,28,39,14,157,high
2175,0,1,Wednesday,19,15,20,17,71,normal
2176,0,1,Wednesday,102,37,48,9,196,heavy
2177,0,1,Wednesday,115,36,41,8,200,heavy
2178,0,1,Wednesday,142,23,23,6,194,heavy
2179,0,1,Wednesday,134,15,29,8,186,heavy
2180,0,1,Wednesday,146,18,49,9,222,heavy
2181,0,1,Wednesday,126,24,48,9,207,heavy
2182,0,1,Wednesday,138,18,27,6,189,heavy
2183,0,1,Wednesday,129,13,43,6,191,heavy
2184,0,1,Wednesday,127,35,23,10,195,heavy
2185,0,1,Wednesday,144,20,22,7,193,heavy
2186,0,1,Wednesday,117,19,31,7,174,heavy
2187,0,1,Wednesday,87,10,13,16,126,normal
2188,0,1,Wednesday,87,6,18,30,141,high
2189,0,1,Wednesday,97,18,10,24,149,high
2190,0,1,Wednesday,71,21,14,12,118,normal
2191,0,1,Wednesday,96,24,18,10,148,normal
2192,0,1,Wednesday,90,7,17,31,145,high
2193,0,1,Wednesday,74,6,12,34,126,high
2194,0,1,Wednesday,59,7,15,20,101,normal
2195,0,1,Wednesday,87,11,16,28,142,high
2196,0,1,Wednesday,62,22,20,20,124,normal
2197,0,1,Wednesday,71,16,14,9,110,low
2198,0,1,Wednesday,98,9,15,18,140,normal
2199,0,1,Wednesday,93,8,10,16,127,normal
2200,0,1,Wednesday,17,4,0,36,57,normal
2201,0,1,Wednesday,16,1,1,29,47,normal
2202,0,1,Wednesday,15,2,0,10,27,low
2203,0,1,Wednesday,10,3,1,23,37,normal
2204,0,1,Wednesday,12,4,0,31,47,normal
2205,0,1,Wednesday,20,1,1,24,46,normal
2206,0,1,Wednesday,11,0,1,23,35,normal
2207,0,1,Wednesday,14,1,1,17,33,normal
2208,0,2,Thursday,12,5,1,38,56,normal
2209,0,2,Thursday,15,4,1,29,49,normal
2210,0,2,Thursday,12,4,0,40,56,normal
2211,0,2,Thursday,11,5,0,22,38,normal
2212,0,2,Thursday,14,5,1,21,41,normal
2213,0,2,Thursday,14,3,0,39,56,normal
2214,0,2,Thursday,10,4,1,11,26,low
2215,0,2,Thursday,11,0,0,16,27,normal
2216,0,2,Thursday,12,3,0,39,54,normal
2217,0,2,Thursday,11,0,1,36,48,normal
2218,0,2,Thursday,16,2,0,35,53,normal
2219,0,2,Thursday,17,3,1,36,57,normal
2220,0,2,Thursday,13,1,1,13,28,normal
2221,0,2,Thursday,14,5,0,19,38,normal
2222,0,2,Thursday,17,5,1,15,38,normal
2223,0,2,Thursday,19,3,0,13,35,normal
2224,0,2,Thursday,19,3,1,12,35,low
2225,0,2,Thursday,54,15,10,8,87,low
2226,0,2,Thursday,107,0,1,2,110,low
2227,0,2,Thursday,116,20,5,14,155,normal
2228,0,2,Thursday,78,2,4,9,93,low
2229,0,2,Thursday,111,22,0,12,145,normal
2230,0,2,Thursday,85,27,7,17,136,normal
2231,0,2,Thursday,95,5,9,20,129,normal
2232,0,2,Thursday,143,33,27,1,204,heavy
2233,0,2,Thursday,133,40,37,0,210,heavy
2234,0,2,Thursday,123,37,34,4,198,heavy
2235,0,2,Thursday,133,34,36,1,204,heavy
2236,0,2,Thursday,101,20,42,4,167,normal
2237,0,2,Thursday,145,10,37,0,192,heavy
2238,0,2,Thursday,141,39,40,5,225,heavy
2239,0,2,Thursday,134,12,22,2,170,heavy
2240,0,2,Thursday,126,10,26,4,166,high
2241,0,2,Thursday,136,22,31,0,189,heavy
2242,0,2,Thursday,128,26,42,4,200,heavy
2243,0,2,Thursday,106,12,28,4,150,high
2244,0,2,Thursday,140,27,36,2,205,heavy
2245,0,2,Thursday,40,20,37,28,125,high
2246,0,2,Thursday,13,25,33,12,83,normal
2247,0,2,Thursday,18,22,26,10,76,normal
2248,0,2,Thursday,59,5,36,12,112,high
2249,0,2,Thursday,48,9,30,14,101,normal
2250,0,2,Thursday,77,23,14,20,134,normal
2251,0,2,Thursday,17,13,13,27,70,normal
2252,0,2,Thursday,36,5,14,25,80,normal
2253,0,2,Thursday,60,10,3,28,101,normal
2254,0,2,Thursday,34,5,4,29,72,normal
2255,0,2,Thursday,63,5,6,20,94,normal
2256,0,2,Thursday,48,10,13,23,94,normal
2257,0,2,Thursday,44,5,5,21,75,normal
2258,0,2,Thursday,62,5,14,23,104,normal
2259,0,2,Thursday,38,8,15,27,88,normal
2260,0,2,Thursday,26,6,9,29,70,normal
2261,0,2,Thursday,78,23,16,13,130,normal
2262,0,2,Thursday,116,21,22,17,176,heavy
2263,0,2,Thursday,94,13,11,16,134,normal
2264,0,2,Thursday,52,19,26,10,107,normal
2265,0,2,Thursday,70,13,12,10,105,low
2266,0,2,Thursday,34,17,21,14,86,normal
2267,0,2,Thursday,16,18,40,6,80,normal
2268,0,2,Thursday,24,20,15,17,76,normal
2269,0,2,Thursday,21,15,33,12,81,normal
2270,0,2,Thursday,100,10,18,7,135,normal
2271,0,2,Thursday,117,22,11,5,155,normal
2272,0,2,Thursday,145,30,40,8,223,normal
2273,0,2,Thursday,113,38,45,7,203,heavy
2274,0,2,Thursday,110,31,37,7,185,heavy
2275,0,2,Thursday,126,15,26,6,173,heavy
2276,0,2,Thursday,100,15,29,7,151,high
2277,0,2,Thursday,147,28,29,10,214,heavy
2278,0,2,Thursday,146,22,50,10,228,heavy
2279,0,2,Thursday,148,23,27,5,203,heavy
2280,0,2,Thursday,149,17,41,9,216,heavy
2281,0,2,Thursday,136,32,41,7,216,heavy
2282,0,2,Thursday,101,22,33,9,165,high
2283,0,2,Thursday,87,18,13,34,152,high
2284,0,2,Thursday,50,21,14,9,94,low
2285,0,2,Thursday,63,23,19,34,139,high
2286,0,2,Thursday,73,9,11,5,98,low
2287,0,2,Thursday,78,13,20,25,136,high
2288,0,2,Thursday,71,22,12,14,119,normal
2289,0,2,Thursday,80,17,11,15,123,normal
2290,0,2,Thursday,62,21,10,35,128,high
2291,0,2,Thursday,100,17,16,33,166,high
2292,0,2,Thursday,95,15,18,9,137,normal
2293,0,2,Thursday,102,14,15,34,165,high
2294,0,2,Thursday,68,12,15,32,127,high
2295,0,2,Thursday,74,5,19,5,103,normal
2296,0,2,Thursday,15,4,1,21,41,normal
2297,0,2,Thursday,16,0,1,24,41,normal
2298,0,2,Thursday,12,0,0,12,24,low
2299,0,2,Thursday,12,5,0,23,40,normal
2300,0,2,Thursday,15,2,1,14,32,normal
2301,0,2,Thursday,10,3,0,23,36,normal
2302,0,2,Thursday,16,2,0,35,53,normal
2303,0,2,Thursday,13,3,0,22,38,normal
2304,0,3,Friday,13,0,0,32,45,normal
2305,0,3,Friday,11,1,0,27,39,normal
2306,0,3,Friday,17,1,0,32,50,normal
2307,0,3,Friday,11,2,0,17,30,normal
2308,0,3,Friday,14,1,1,11,27,low
2309,0,3,Friday,17,2,0,33,52,normal
2310,0,3,Friday,15,2,1,38,56,normal
2311,0,3,Friday,13,4,1,24,42,normal
2312,0,3,Friday,11,5,1,11,28,low
2313,0,3,Friday,12,3,0,22,37,normal
2314,0,3,Friday,15,1,0,26,42,normal
2315,0,3,Friday,13,0,1,34,48,normal
2316,0,3,Friday,17,5,0,15,37,normal
2317,0,3,Friday,20,3,1,26,50,normal
2318,0,3,Friday,18,4,0,30,52,normal
2319,0,3,Friday,12,1,1,19,33,normal
2320,0,3,Friday,20,0,0,12,32,low
2321,0,3,Friday,29,10,0,12,51,low
2322,0,3,Friday,39,20,1,10,70,low
2323,0,3,Friday,76,9,7,13,105,normal
2324,0,3,Friday,33,17,0,13,63,normal
2325,0,3,Friday,64,14,1,12,91,low
2326,0,3,Friday,44,7,1,11,63,low
2327,0,3,Friday,53,8,4,15,80,normal
2328,0,3,Friday,75,6,7,13,101,normal
2329,0,3,Friday,60,11,4,10,85,low
2330,0,3,Friday,35,14,2,14,65,normal
2331,0,3,Friday,75,20,6,15,116,normal
2332,0,3,Friday,27,10,2,12,51,low
2333,0,3,Friday,61,20,7,14,102,normal
2334,0,3,Friday,72,20,5,15,112,normal
2335,0,3,Friday,43,18,6,14,81,normal
2336,0,3,Friday,54,10,4,14,82,normal
2337,0,3,Friday,30,12,1,14,57,normal
2338,0,3,Friday,72,8,6,12,98,low
2339,0,3,Friday,55,17,7,15,94,normal
2340,0,3,Friday,36,20,0,13,69,normal
2341,0,3,Friday,168,55,10,0,233,heavy
2342,0,3,Friday,135,61,28,2,226,heavy
2343,0,3,Friday,168,68,27,2,265,heavy
2344,0,3,Friday,139,44,16,1,200,heavy
2345,0,3,Friday,156,63,12,3,234,heavy
2346,0,3,Friday,141,51,27,3,222,heavy
2347,0,3,Friday,144,44,16,3,207,heavy
2348,0,3,Friday,132,65,23,0,220,heavy
2349,0,3,Friday,180,48,17,2,247,heavy
2350,0,3,Friday,140,67,20,4,231,heavy
2351,0,3,Friday,163,62,12,0,237,heavy
2352,0,3,Friday,148,70,15,0,233,heavy
2353,0,3,Friday,134,47,22,3,206,heavy
2354,0,3,Friday,162,51,13,0,226,heavy
2355,0,3,Friday,136,49,15,1,201,heavy
2356,0,3,Friday,147,52,26,0,225,heavy
2357,0,3,Friday,174,54,25,1,254,heavy
2358,0,3,Friday,135,69,20,1,225,heavy
2359,0,3,Friday,142,55,21,1,219,heavy
2360,0,3,Friday,144,59,14,2,219,heavy
2361,0,3,Friday,180,49,17,0,246,heavy
2362,0,3,Friday,153,59,20,4,236,heavy
2363,0,3,Friday,139,43,27,3,212,heavy
2364,0,3,Friday,179,60,12,0,251,heavy
2365,0,3,Friday,76,21,6,1,104,low
2366,0,3,Friday,59,25,19,1,104,normal
2367,0,3,Friday,51,20,12,1,84,low
2368,0,3,Friday,78,24,19,2,123,normal
2369,0,3,Friday,50,24,11,0,85,low
2370,0,3,Friday,59,25,8,0,92,low
2371,0,3,Friday,90,21,0,0,111,low
2372,0,3,Friday,79,26,21,2,128,normal
2373,0,3,Friday,56,21,4,1,82,low
2374,0,3,Friday,70,25,11,2,108,low
2375,0,3,Friday,54,27,21,2,104,normal
2376,0,3,Friday,53,22,13,2,90,low
2377,0,3,Friday,59,27,5,2,93,low
2378,0,3,Friday,63,30,21,0,114,normal
2379,0,3,Friday,87,21,16,0,124,normal
2380,0,3,Friday,71,26,19,1,117,normal
2381,0,3,Friday,32,5,5,13,55,normal
2382,0,3,Friday,36,6,7,2,51,low
2383,0,3,Friday,35,10,0,2,47,low
2384,0,3,Friday,40,10,5,10,65,low
2385,0,3,Friday,44,6,1,3,54,low
2386,0,3,Friday,40,6,1,3,50,low
2387,0,3,Friday,45,2,7,7,61,low
2388,0,3,Friday,44,2,6,5,57,low
2389,0,3,Friday,33,4,4,5,46,low
2390,0,3,Friday,22,5,3,13,43,normal
2391,0,3,Friday,33,5,5,1,44,low
2392,0,3,Friday,10,0,0,29,39,normal
2393,0,3,Friday,19,3,1,35,58,normal
2394,0,3,Friday,10,4,0,30,44,normal
2395,0,3,Friday,12,3,1,25,41,normal
2396,0,3,Friday,12,1,0,40,53,normal
2397,0,3,Friday,20,2,0,19,41,normal
2398,0,3,Friday,18,4,1,11,34,low
2399,0,3,Friday,19,1,1,37,58,normal
2400,0,4,Saturday,13,2,0,25,40,normal
2401,0,4,Saturday,16,4,1,15,36,normal
2402,0,4,Saturday,10,4,1,16,31,normal
2403,0,4,Saturday,18,3,0,19,40,normal
2404,0,4,Saturday,15,5,0,10,30,low
2405,0,4,Saturday,14,2,1,22,39,normal
2406,0,4,Saturday,15,0,0,15,30,normal
2407,0,4,Saturday,17,5,0,21,43,normal
2408,0,4,Saturday,14,0,1,12,27,low
2409,0,4,Saturday,10,1,0,11,22,low
2410,0,4,Saturday,18,5,0,18,41,normal
2411,0,4,Saturday,12,4,0,11,27,low
2412,0,4,Saturday,17,0,1,30,48,normal
2413,0,4,Saturday,20,1,0,28,49,normal
2414,0,4,Saturday,19,5,1,38,63,normal
2415,0,4,Saturday,15,0,0,36,51,normal
2416,0,4,Saturday,10,2,0,30,42,normal
2417,0,4,Saturday,74,4,4,13,95,normal
2418,0,4,Saturday,96,29,6,17,148,normal
2419,0,4,Saturday,109,16,6,12,143,normal
2420,0,4,Saturday,113,6,9,10,138,normal
2421,0,4,Saturday,90,24,8,20,142,normal
2422,0,4,Saturday,106,19,10,17,152,normal
2423,0,4,Saturday,96,7,6,4,113,normal
2424,0,4,Saturday,102,21,42,3,168,heavy
2425,0,4,Saturday,140,35,50,0,225,heavy
2426,0,4,Saturday,105,33,29,4,171,heavy
2427,0,4,Saturday,134,26,27,1,188,heavy
2428,0,4,Saturday,123,35,45,1,204,heavy
2429,0,4,Saturday,128,31,26,0,185,heavy
2430,0,4,Saturday,105,32,43,0,180,heavy
2431,0,4,Saturday,137,13,31,5,186,heavy
2432,0,4,Saturday,148,37,46,2,233,heavy
2433,0,4,Saturday,105,14,35,2,156,high
2434,0,4,Saturday,148,17,42,5,212,heavy
2435,0,4,Saturday,116,22,30,3,171,heavy
2436,0,4,Saturday,143,28,46,1,218,heavy
2437,0,4,Saturday,30,24,13,13,80,normal
2438,0,4,Saturday,74,23,35,10,142,high
2439,0,4,Saturday,67,5,36,17,125,high
2440,0,4,Saturday,59,11,33,25,128,high
2441,0,4,Saturday,34,21,39,16,110,normal
2442,0,4,Saturday,72,24,10,9,115,normal
2443,0,4,Saturday,73,12,32,5,122,high
2444,0,4,Saturday,26,8,8,24,66,normal
2445,0,4,Saturday,47,5,7,28,87,normal
2446,0,4,Saturday,33,10,6,29,78,normal
2447,0,4,Saturday,39,8,13,20,80,normal
2448,0,4,Saturday,36,5,14,22,77,normal
2449,0,4,Saturday,53,9,15,25,102,normal
2450,0,4,Saturday,37,9,10,30,86,normal
2451,0,4,Saturday,54,8,4,27,93,normal
2452,0,4,Saturday,20,8,15,26,69,normal
2453,0,4,Saturday,47,29,28,9,113,high
2454,0,4,Saturday,51,27,10,20,108,normal
2455,0,4,Saturday,114,11,40,20,185,heavy
2456,0,4,Saturday,73,13,19,9,114,normal
2457,0,4,Saturday,28,19,27,5,79,normal
2458,0,4,Saturday,105,20,20,11,156,normal
2459,0,4,Saturday,68,24,15,14,121,normal
2460,0,4,Saturday,112,16,30,11,169,heavy
2461,0,4,Saturday,120,30,28,15,193,heavy
2462,0,4,Saturday,38,27,12,18,95,normal
2463,0,4,Saturday,94,17,14,15,140,normal
2464,0,4,Saturday,107,28,45,8,188,heavy
2465,0,4,Saturday,100,16,49,7,172,heavy
2466,0,4,Saturday,145,15,20,9,189,heavy
2467,0,4,Saturday,133,17,22,8,180,heavy
2468,0,4,Saturday,117,36,41,10,204,heavy
2469,0,4,Saturday,113,26,26,8,173,heavy
2470,0,4,Saturday,101,20,21,9,151,normal
2471,0,4,Saturday,149,33,45,10,237,heavy
2472,0,4,Saturday,134,35,26,7,202,heavy
2473,0,4,Saturday,106,11,45,9,171,heavy
2474,0,4,Saturday,121,37,34,6,198,heavy
2475,0,4,Saturday,97,13,11,15,136,normal
2476,0,4,Saturday,91,17,18,29,155,high
2477,0,4,Saturday,57,16,13,19,105,normal
2478,0,4,Saturday,110,10,10,20,150,normal
2479,0,4,Saturday,71,14,17,30,132,high
2480,0,4,Saturday,89,25,20,24,158,high
2481,0,4,Saturday,87,16,15,14,132,normal
2482,0,4,Saturday,106,12,16,9,143,normal
2483,0,4,Saturday,78,10,19,20,127,normal
2484,0,4,Saturday,61,10,16,27,114,high
2485,0,4,Saturday,74,19,15,24,132,high
2486,0,4,Saturday,56,20,11,25,112,high
2487,0,4,Saturday,106,22,16,18,162,normal
2488,0,4,Saturday,10,1,1,12,24,low
2489,0,4,Saturday,12,4,1,33,50,normal
2490,0,4,Saturday,16,4,0,16,36,normal
2491,0,4,Saturday,18,1,0,18,37,normal
2492,0,4,Saturday,19,2,0,36,57,normal
2493,0,4,Saturday,18,4,1,35,58,normal
2494,0,4,Saturday,17,0,0,31,48,normal
2495,0,4,Saturday,18,1,0,16,35,normal
2496,0,5,Sunday,15,4,0,37,56,normal
2497,0,5,Sunday,11,5,0,14,30,normal
2498,0,5,Sunday,11,5,0,22,38,normal
2499,0,5,Sunday,12,2,1,37,52,normal
2500,0,5,Sunday,18,1,1,34,54,normal
2501,0,5,Sunday,19,1,0,11,31,low
2502,0,5,Sunday,11,4,1,26,42,normal
2503,0,5,Sunday,18,3,0,28,49,normal
2504,0,5,Sunday,12,4,1,37,54,normal
2505,0,5,Sunday,11,1,1,29,42,normal
2506,0,5,Sunday,19,5,1,29,54,normal
2507,0,5,Sunday,18,4,0,11,33,low
2508,0,5,Sunday,16,4,0,29,49,normal
2509,0,5,Sunday,19,4,1,33,57,normal
2510,0,5,Sunday,15,3,1,12,31,low
2511,0,5,Sunday,16,4,1,28,49,normal
2512,0,5,Sunday,11,4,0,20,35,normal
2513,0,5,Sunday,93,4,1,16,114,normal
2514,0,5,Sunday,114,12,7,18,151,normal
2515,0,5,Sunday,56,7,5,20,88,normal
2516,0,5,Sunday,92,23,3,19,137,normal
2517,0,5,Sunday,99,6,6,7,118,normal
2518,0,5,Sunday,108,14,6,9,137,normal
2519,0,5,Sunday,66,20,2,16,104,normal
2520,0,5,Sunday,147,26,44,5,222,heavy
2521,0,5,Sunday,139,27,29,1,196,heavy
2522,0,5,Sunday,119,31,36,5,191,heavy
2523,0,5,Sunday,114,30,21,2,167,normal
2524,0,5,Sunday,103,27,21,4,155,normal
2525,0,5,Sunday,105,17,29,4,155,high
2526,0,5,Sunday,124,29,41,1,195,heavy
2527,0,5,Sunday,118,19,34,1,172,heavy
2528,0,5,Sunday,101,37,32,0,170,heavy
2529,0,5,Sunday,109,11,48,1,169,heavy
2530,0,5,Sunday,143,12,23,3,181,heavy
2531,0,5,Sunday,143,40,30,0,213,heavy
2532,0,5,Sunday,128,16,34,0,178,heavy
2533,0,5,Sunday,14,25,14,16,69,normal
2534,0,5,Sunday,99,10,11,15,135,normal
2535,0,5,Sunday,67,1,22,14,104,normal
2536,0,5,Sunday,42,2,29,9,82,normal
2537,0,5,Sunday,92,3,33,21,149,high
2538,0,5,Sunday,91,16,28,9,144,high
2539,0,5,Sunday,25,9,10,28,72,normal
2540,0,5,Sunday,37,5,12,29,83,normal
2541,0,5,Sunday,55,6,12,29,102,normal
2542,0,5,Sunday,49,8,8,26,91,normal
2543,0,5,Sunday,69,9,3,20,101,normal
2544,0,5,Sunday,38,6,6,24,74,normal
2545,0,5,Sunday,40,8,12,21,81,normal
2546,0,5,Sunday,53,5,3,20,81,normal
2547,0,5,Sunday,21,8,4,28,61,normal
2548,0,5,Sunday,24,7,4,20,55,normal
2549,0,5,Sunday,47,24,24,9,104,normal
2550,0,5,Sunday,90,30,32,8,160,high
2551,0,5,Sunday,120,21,22,14,177,heavy
2552,0,5,Sunday,120,12,40,13,185,heavy
2553,0,5,Sunday,66,14,21,7,108,normal
2554,0,5,Sunday,89,24,12,6,131,normal
2555,0,5,Sunday,80,17,16,5,118,normal
2556,0,5,Sunday,114,21,10,9,154,normal
2557,0,5,Sunday,94,20,7,10,131,normal
2558,0,5,Sunday,70,18,28,5,121,high
2559,0,5,Sunday,56,17,15,8,96,low
2560,0,5,Sunday,141,15,20,6,182,heavy
2561,0,5,Sunday,150,19,46,7,222,heavy
2562,0,5,Sunday,119,37,22,8,186,heavy
2563,0,5,Sunday,144,14,44,5,207,heavy
2564,0,5,Sunday,110,25,46,6,187,heavy
2565,0,5,Sunday,138,15,31,10,194,heavy
2566,0,5,Sunday,140,35,41,5,221,heavy
2567,0,5,Sunday,103,24,28,8,163,high
2568,0,5,Sunday,142,27,30,5,204,heavy
2569,0,5,Sunday,149,13,22,9,193,heavy
2570,0,5,Sunday,126,40,39,8,213,heavy
2571,0,5,Sunday,78,15,14,28,135,high
2572,0,5,Sunday,102,15,11,29,157,high
2573,0,5,Sunday,96,22,20,12,150,normal
2574,0,5,Sunday,110,24,15,14,163,normal
2575,0,5,Sunday,97,22,17,13,149,normal
2576,0,5,Sunday,53,19,11,18,101,normal
2577,0,5,Sunday,82,8,17,29,136,high
2578,0,5,Sunday,91,24,18,29,162,high
2579,0,5,Sunday,102,6,14,35,157,high
2580,0,5,Sunday,109,6,15,18,148,normal
2581,0,5,Sunday,78,16,13,27,134,high
2582,0,5,Sunday,66,12,16,33,127,high
2583,0,5,Sunday,100,17,15,22,154,high
2584,0,5,Sunday,15,1,1,25,42,normal
2585,0,5,Sunday,16,1,0,33,50,normal
2586,0,5,Sunday,19,4,0,26,49,normal
2587,0,5,Sunday,10,0,1,34,45,normal
2588,0,5,Sunday,14,0,0,28,42,normal
2589,0,5,Sunday,13,2,0,22,37,normal
2590,0,5,Sunday,18,5,1,20,44,normal
2591,0,5,Sunday,18,4,0,18,40,normal
2592,0,6,Monday,11,3,0,26,40,normal
2593,0,6,Monday,13,1,0,24,38,normal
2594,0,6,Monday,19,5,1,15,40,normal
2595,0,6,Monday,11,3,1,28,43,normal
2596,0,6,Monday,11,1,1,40,53,normal
2597,0,6,Monday,18,4,1,28,51,normal
2598,0,6,Monday,15,2,1,16,34,normal
2599,0,6,Monday,20,0,0,27,47,normal
2600,0,6,Monday,14,5,0,17,36,normal
2601,0,6,Monday,11,3,1,10,25,low
2602,0,6,Monday,18,5,0,22,45,normal
2603,0,6,Monday,12,4,0,16,32,normal
2604,0,6,Monday,10,2,0,24,36,normal
2605,0,6,Monday,20,0,1,36,57,normal
2606,0,6,Monday,20,1,0,29,50,normal
2607,0,6,Monday,16,4,0,24,44,normal
2608,0,6,Monday,18,3,0,22,43,normal
2609,0,6,Monday,88,11,10,3,112,normal
2610,0,6,Monday,114,5,9,7,135,normal
2611,0,6,Monday,103,3,9,17,132,normal
2612,0,6,Monday,81,16,7,14,118,normal
2613,0,6,Monday,94,1,9,3,107,low
2614,0,6,Monday,56,11,9,15,91,normal
2615,0,6,Monday,80,16,5,10,111,low
2616,0,6,Monday,138,35,47,4,224,heavy
2617,0,6,Monday,123,27,22,4,176,heavy
2618,0,6,Monday,114,30,36,2,182,heavy
2619,0,6,Monday,122,30,37,2,191,heavy
2620,0,6,Monday,148,10,28,2,188,heavy
2621,0,6,Monday,127,38,48,0,213,heavy
2622,0,6,Monday,113,32,44,1,190,heavy
2623,0,6,Monday,131,26,40,1,198,heavy
2624,0,6,Monday,108,27,44,5,184,heavy
2625,0,6,Monday,109,19,49,3,180,heavy
2626,0,6,Monday,125,15,28,3,171,heavy
2627,0,6,Monday,139,30,35,4,208,heavy
2628,0,6,Monday,103,35,50,2,190,heavy
2629,0,6,Monday,64,13,40,12,129,high
2630,0,6,Monday,79,1,10,30,120,high
2631,0,6,Monday,50,2,7,14,73,normal
2632,0,6,Monday,84,18,18,28,148,high
2633,0,6,Monday,99,16,39,26,180,heavy
2634,0,6,Monday,42,3,27,18,90,normal
2635,0,6,Monday,53,2,29,24,108,normal
2636,0,6,Monday,63,10,8,28,109,normal
2637,0,6,Monday,24,8,3,20,55,normal
2638,0,6,Monday,46,8,6,26,86,normal
2639,0,6,Monday,20,7,8,26,61,normal
2640,0,6,Monday,41,8,7,27,83,normal
2641,0,6,Monday,44,5,3,28,80,normal
2642,0,6,Monday,33,6,14,28,81,normal
2643,0,6,Monday,30,9,7,25,71,normal
2644,0,6,Monday,68,7,5,25,105,normal
2645,0,6,Monday,28,29,26,5,88,normal
2646,0,6,Monday,96,20,14,18,148,normal
2647,0,6,Monday,24,15,26,13,78,normal
2648,0,6,Monday,70,21,32,18,141,high
2649,0,6,Monday,49,21,11,20,101,normal
2650,0,6,Monday,51,22,12,16,101,normal
2651,0,6,Monday,84,12,15,15,126,normal
2652,0,6,Monday,99,18,7,20,144,normal
2653,0,6,Monday,106,10,9,8,133,normal
2654,0,6,Monday,6,11,34,20,71,normal
2655,0,6,Monday,59,29,15,16,119,normal
2656,0,6,Monday,139,25,41,5,210,heavy
2657,0,6,Monday,109,12,49,6,176,heavy
2658,0,6,Monday,124,24,47,9,204,heavy
2659,0,6,Monday,135,29,39,7,210,heavy
2660,0,6,Monday,137,15,37,7,196,heavy
2661,0,6,Monday,119,28,46,9,202,heavy
2662,0,6,Monday,127,21,28,5,181,heavy
2663,0,6,Monday,109,37,44,9,199,heavy
2664,0,6,Monday,145,27,35,7,214,heavy
2665,0,6,Monday,133,36,28,6,203,heavy
2666,0,6,Monday,138,19,36,5,198,heavy
2667,0,6,Monday,73,5,20,10,108,normal
2668,0,6,Monday,83,11,14,33,141,high
2669,0,6,Monday,89,8,10,19,126,normal
2670,0,6,Monday,99,19,18,24,160,high
2671,0,6,Monday,54,17,14,8,93,low
2672,0,6,Monday,58,18,14,6,96,low
2673,0,6,Monday,56,16,12,9,93,low
2674,0,6,Monday,77,6,20,5,108,normal
2675,0,6,Monday,85,6,18,17,126,normal
2676,0,6,Monday,105,14,13,32,164,high
2677,0,6,Monday,96,21,11,24,152,high
2678,0,6,Monday,66,22,17,16,121,normal
2679,0,6,Monday,88,15,19,14,136,normal
2680,0,6,Monday,16,1,1,24,42,normal
2681,0,6,Monday,13,1,0,11,25,low
2682,0,6,Monday,13,5,1,23,42,normal
2683,0,6,Monday,19,5,0,37,61,normal
2684,0,6,Monday,19,1,0,31,51,normal
2685,0,6,Monday,11,5,0,19,35,normal
2686,0,6,Monday,18,3,0,32,53,normal
2687,0,6,Monday,17,1,1,38,57,normal
2688,0,7,Tuesday,17,3,0,20,40,normal
2689,0,7,Tuesday,18,4,1,19,42,normal
2690,0,7,Tuesday,19,3,0,24,46,normal
2691,0,7,Tuesday,16,3,0,15,34,normal
2692,0,7,Tuesday,12,5,1,21,39,normal
2693,0,7,Tuesday,17,3,0,36,56,normal
2694,0,7,Tuesday,19,4,1,21,45,normal
2695,0,7,Tuesday,13,5,0,20,38,normal
2696,0,7,Tuesday,14,0,1,37,52,normal
2697,0,7,Tuesday,14,5,0,39,58,normal
2698,0,7,Tuesday,13,1,0,19,33,normal
2699,0,7,Tuesday,18,5,1,25,49,normal
2700,0,7,Tuesday,15,1,1,15,32,normal
2701,0,7,Tuesday,19,2,0,30,51,normal
2702,0,7,Tuesday,18,2,1,27,48,normal
2703,0,7,Tuesday,13,1,0,38,52,normal
2704,0,7,Tuesday,19,2,0,32,53,normal
2705,0,7,Tuesday,116,0,1,9,126,normal
2706,0,7,Tuesday,60,12,8,15,95,normal
2707,0,7,Tuesday,82,15,0,19,116,normal
2708,0,7,Tuesday,67,23,7,3,100,low
2709,0,7,Tuesday,59,27,10,18,114,normal
2710,0,7,Tuesday,66,6,9,5,86,low
2711,0,7,Tuesday,120,10,3,16,149,normal
2712,0,7,Tuesday,121,22,30,0,173,heavy
2713,0,7,Tuesday,130,27,39,5,201,heavy
2714,0,7,Tuesday,139,31,44,3,217,heavy
2715,0,7,Tuesday,129,14,43,5,191,heavy
2716,0,7,Tuesday,131,28,43,5,207,heavy
2717,0,7,Tuesday,119,39,24,1,183,heavy
2718,0,7,Tuesday,142,25,34,5,206,heavy
2719,0,7,Tuesday,123,22,22,3,170,heavy
2720,0,7,Tuesday,106,19,38,4,167,normal
2721,0,7,Tuesday,115,39,20,2,176,heavy
2722,0,7,Tuesday,111,17,32,1,161,high
2723,0,7,Tuesday,144,26,50,3,223,normal
2724,0,7,Tuesday,126,31,48,2,207,heavy
2725,0,7,Tuesday,73,22,21,29,145,high
2726,0,7,Tuesday,28,7,25,18,78,normal
2727,0,7,Tuesday,31,10,40,9,90,normal
2728,0,7,Tuesday,51,14,33,14,112,high
2729,0,7,Tuesday,22,7,39,23,91,normal
2730,0,7,Tuesday,46,5,11,21,83,normal
2731,0,7,Tuesday,72,22,21,27,142,high
2732,0,7,Tuesday,70,5,5,29,109,normal
2733,0,7,Tuesday,28,9,9,24,70,normal
2734,0,7,Tuesday,44,5,11,23,83,normal
2735,0,7,Tuesday,27,6,13,30,76,normal
2736,0,7,Tuesday,20,6,6,23,55,normal
2737,0,7,Tuesday,29,7,3,28,67,normal
2738,0,7,Tuesday,20,6,5,27,58,normal
2739,0,7,Tuesday,65,9,15,22,111,normal
2740,0,7,Tuesday,36,5,6,20,67,normal
2741,0,7,Tuesday,99,21,21,6,147,normal
2742,0,7,Tuesday,101,21,34,18,174,heavy
2743,0,7,Tuesday,98,29,34,12,173,heavy
2744,0,7,Tuesday,113,20,7,13,153,normal
2745,0,7,Tuesday,75,24,27,7,133,high
2746,0,7,Tuesday,71,21,38,11,141,high
2747,0,7,Tuesday,119,13,32,7,171,heavy
2748,0,7,Tuesday,114,11,39,13,177,heavy
2749,0,7,Tuesday,99,26,8,11,144,normal
2750,0,7,Tuesday,39,12,21,9,81,normal
2751,0,7,Tuesday,114,26,16,20,176,heavy
2752,0,7,Tuesday,120,32,39,9,200,heavy
2753,0,7,Tuesday,143,24,35,6,208,heavy
2754,0,7,Tuesday,121,28,21,5,175,heavy
2755,0,7,Tuesday,134,23,28,10,195,heavy
2756,0,7,Tuesday,103,13,37,10,163,high
2757,0,7,Tuesday,122,12,48,10,192,heavy
2758,0,7,Tuesday,145,39,23,6,213,heavy
2759,0,7,Tuesday,105,13,48,10,176,heavy
2760,0,7,Tuesday,144,13,40,10,207,heavy
2761,0,7,Tuesday,103,18,40,5,166,high
2762,0,7,Tuesday,120,15,34,8,177,heavy
2763,0,7,Tuesday,56,19,16,13,104,normal
2764,0,7,Tuesday,56,5,17,14,92,normal
2765,0,7,Tuesday,108,15,13,5,141,normal
2766,0,7,Tuesday,58,23,14,34,129,high
2767,0,7,Tuesday,58,13,11,33,115,high
2768,0,7,Tuesday,76,24,14,15,129,normal
2769,0,7,Tuesday,69,8,13,28,118,high
2770,0,7,Tuesday,54,9,12,10,85,low
2771,0,7,Tuesday,89,7,10,10,116,normal
2772,0,7,Tuesday,110,18,18,10,156,normal
2773,0,7,Tuesday,86,12,17,18,133,normal
2774,0,7,Tuesday,82,7,16,9,114,normal
2775,0,7,Tuesday,102,5,19,11,137,normal
2776,0,7,Tuesday,16,5,0,21,42,normal
2777,0,7,Tuesday,11,3,1,39,54,normal
2778,0,7,Tuesday,18,5,0,11,34,low
2779,0,7,Tuesday,12,0,1,32,45,normal
2780,0,7,Tuesday,15,4,1,39,59,normal
2781,0,7,Tuesday,15,4,0,26,45,normal
2782,0,7,Tuesday,13,1,0,30,44,normal
2783,0,7,Tuesday,12,3,0,28,43,normal
2784,0,8,Wednesday,17,2,1,20,40,normal
2785,0,8,Wednesday,14,5,1,33,53,normal
2786,0,8,Wednesday,16,3,1,11,31,low
2787,0,8,Wednesday,18,2,1,13,34,normal
2788,0,8,Wednesday,12,2,1,17,32,normal
2789,0,8,Wednesday,17,4,1,15,37,normal
2790,0,8,Wednesday,18,1,1,25,45,normal
2791,0,8,Wednesday,20,1,1,10,32,low
2792,0,8,Wednesday,15,1,0,21,37,normal
2793,0,8,Wednesday,11,3,1,34,49,normal
2794,0,8,Wednesday,19,0,1,13,33,normal
2795,0,8,Wednesday,10,3,0,14,27,normal
2796,0,8,Wednesday,17,5,1,17,40,normal
2797,0,8,Wednesday,16,1,0,11,28,low
2798,0,8,Wednesday,11,0,1,33,45,normal
2799,0,8,Wednesday,10,5,0,39,54,normal
2800,0,8,Wednesday,12,3,0,32,47,normal
2801,0,8,Wednesday,106,16,10,10,142,normal
2802,0,8,Wednesday,69,18,0,12,99,low
2803,0,8,Wednesday,103,26,6,12,147,normal
2804,0,8,Wednesday,99,25,6,6,136,normal
2805,0,8,Wednesday,85,9,4,11,109,low
2806,0,8,Wednesday,109,0,3,8,120,normal
2807,0,8,Wednesday,106,27,1,6,140,normal
2808,0,8,Wednesday,133,28,31,3,195,heavy
2809,0,8,Wednesday,108,39,34,5,186,heavy
2810,0,8,Wednesday,101,12,48,1,162,high
2811,0,8,Wednesday,145,11,29,1,186,heavy
2812,0,8,Wednesday,112,33,29,3,177,heavy
2813,0,8,Wednesday,111,18,32,4,165,high
2814,0,8,Wednesday,133,39,44,2,218,heavy
2815,0,8,Wednesday,115,34,37,5,191,heavy
2816,0,8,Wednesday,135,35,38,3,211,heavy
2817,0,8,Wednesday,142,40,28,3,213,heavy
2818,0,8,Wednesday,124,11,27,2,164,high
2819,0,8,Wednesday,122,29,31,5,187,heavy
2820,0,8,Wednesday,101,19,23,5,148,normal
2821,0,8,Wednesday,72,5,15,20,112,normal
2822,0,8,Wednesday,100,13,23,9,145,normal
2823,0,8,Wednesday,32,10,33,8,83,normal
2824,0,8,Wednesday,42,25,37,12,116,high
2825,0,8,Wednesday,81,25,40,20,166,high
2826,0,8,Wednesday,56,18,9,23,106,normal
2827,0,8,Wednesday,84,9,31,17,141,high
2828,0,8,Wednesday,36,9,8,28,81,normal
2829,0,8,Wednesday,32,5,11,27,75,normal
2830,0,8,Wednesday,26,7,15,27,75,normal
2831,0,8,Wednesday,34,5,5,22,66,normal
2832,0,8,Wednesday,66,9,6,30,111,normal
2833,0,8,Wednesday,69,10,4,24,107,normal
2834,0,8,Wednesday,44,7,9,20,80,normal
2835,0,8,Wednesday,58,10,5,27,100,normal
2836,0,8,Wednesday,27,6,14,30,77,normal
2837,0,8,Wednesday,19,21,25,15,80,normal
2838,0,8,Wednesday,39,15,30,8,92,normal
2839,0,8,Wednesday,109,21,10,12,152,normal
2840,0,8,Wednesday,93,10,9,15,127,normal
2841,0,8,Wednesday,73,16,12,11,112,normal
2842,0,8,Wednesday,111,18,29,16,174,heavy
2843,0,8,Wednesday,37,20,10,19,86,normal
2844,0,8,Wednesday,74,23,13,20,130,normal
2845,0,8,Wednesday,32,28,35,6,101,normal
2846,0,8,Wednesday,34,23,19,17,93,normal
2847,0,8,Wednesday,59,25,9,20,113,normal
2848,0,8,Wednesday,145,12,24,8,189,heavy
2849,0,8,Wednesday,118,17,28,8,171,heavy
2850,0,8,Wednesday,145,20,47,8,220,heavy
2851,0,8,Wednesday,140,25,46,10,221,heavy
2852,0,8,Wednesday,120,35,43,7,205,heavy
2853,0,8,Wednesday,126,24,31,7,188,heavy
2854,0,8,Wednesday,106,22,43,5,176,heavy
2855,0,8,Wednesday,137,40,28,9,214,heavy
2856,0,8,Wednesday,108,40,25,6,179,heavy
2857,0,8,Wednesday,135,15,50,6,206,heavy
2858,0,8,Wednesday,121,21,49,8,199,heavy
2859,0,8,Wednesday,59,6,20,6,91,normal
2860,0,8,Wednesday,59,13,18,27,117,high
2861,0,8,Wednesday,103,7,15,15,140,normal
2862,0,8,Wednesday,56,14,14,31,115,high
2863,0,8,Wednesday,106,23,12,9,150,normal
2864,0,8,Wednesday,109,5,16,17,147,normal
2865,0,8,Wednesday,110,5,20,11,146,normal
2866,0,8,Wednesday,86,15,15,23,139,high
2867,0,8,Wednesday,91,18,19,26,154,high
2868,0,8,Wednesday,99,19,15,28,161,high
2869,0,8,Wednesday,93,14,20,17,144,normal
2870,0,8,Wednesday,89,25,13,23,150,high
2871,0,8,Wednesday,107,15,12,24,158,high
2872,0,8,Wednesday,16,5,0,14,35,normal
2873,0,8,Wednesday,14,5,1,20,40,normal
2874,0,8,Wednesday,18,3,0,24,45,normal
2875,0,8,Wednesday,12,3,0,40,55,normal
2876,0,8,Wednesday,14,4,1,27,46,normal
2877,0,8,Wednesday,18,5,1,15,39,normal
2878,0,8,Wednesday,10,4,1,23,38,normal
2879,0,8,Wednesday,10,5,0,14,29,normal
2880,0,9,Thursday,14,3,0,28,45,normal
2881,0,9,Thursday,10,2,0,38,50,normal
2882,0,9,Thursday,19,0,0,32,51,normal
2883,0,9,Thursday,20,3,0,19,42,normal
2884,0,9,Thursday,18,3,0,14,35,normal
2885,0,9,Thursday,11,2,0,12,25,low
2886,0,9,Thursday,17,1,1,13,32,normal
2887,0,9,Thursday,10,0,1,36,47,normal
2888,0,9,Thursday,17,0,0,32,49,normal
2889,0,9,Thursday,20,5,1,22,48,normal
2890,0,9,Thursday,12,3,0,17,32,normal
2891,0,9,Thursday,13,0,0,31,44,normal
2892,0,9,Thursday,11,1,1,35,48,normal
2893,0,9,Thursday,18,2,0,19,39,normal
2894,0,9,Thursday,15,0,1,24,40,normal
2895,0,9,Thursday,14,3,0,25,42,normal
2896,0,9,Thursday,12,0,1,16,29,normal
2897,0,9,Thursday,85,24,5,5,119,normal
2898,0,9,Thursday,71,22,5,2,100,low
2899,0,9,Thursday,108,4,5,3,120,normal
2900,0,9,Thursday,63,29,5,15,112,normal
2901,0,9,Thursday,62,12,3,18,95,normal
2902,0,9,Thursday,118,15,3,11,147,normal
2903,0,9,Thursday,90,21,2,14,127,normal
2904,0,9,Thursday,141,30,31,1,203,heavy
2905,0,9,Thursday,126,31,33,2,192,heavy
2906,0,9,Thursday,112,26,30,4,172,heavy
2907,0,9,Thursday,112,12,38,4,166,high
2908,0,9,Thursday,144,14,33,4,195,heavy
2909,0,9,Thursday,127,13,36,1,177,heavy
2910,0,9,Thursday,146,10,44,5,205,heavy
2911,0,9,Thursday,146,22,26,4,198,heavy
2912,0,9,Thursday,101,10,48,5,164,high
2913,0,9,Thursday,104,19,24,4,151,normal
2914,0,9,Thursday,150,20,43,0,213,heavy
2915,0,9,Thursday,110,35,45,2,192,heavy
2916,0,9,Thursday,139,15,28,2,184,heavy
2917,0,9,Thursday,99,17,32,7,155,high
2918,0,9,Thursday,22,15,7,19,63,normal
2919,0,9,Thursday,11,12,21,24,68,normal
2920,0,9,Thursday,47,20,18,16,101,normal
2921,0,9,Thursday,54,1,35,26,116,high
2922,0,9,Thursday,26,16,13,16,71,normal
2923,0,9,Thursday,99,18,39,19,175,heavy
2924,0,9,Thursday,31,9,11,28,79,normal
2925,0,9,Thursday,24,8,13,23,68,normal
2926,0,9,Thursday,21,7,9,20,57,normal
2927,0,9,Thursday,60,10,5,25,100,normal
2928,0,9,Thursday,29,9,12,21,71,normal
2929,0,9,Thursday,37,7,14,28,86,normal
2930,0,9,Thursday,53,7,11,22,93,normal
2931,0,9,Thursday,35,5,15,25,80,normal
2932,0,9,Thursday,53,6,10,28,97,normal
2933,0,9,Thursday,114,18,17,8,157,normal
2934,0,9,Thursday,95,28,22,9,154,normal
2935,0,9,Thursday,62,23,38,19,142,high
2936,0,9,Thursday,70,28,12,12,122,normal
2937,0,9,Thursday,35,20,10,8,73,low
2938,0,9,Thursday,60,23,10,20,113,normal
2939,0,9,Thursday,40,22,25,9,96,normal
2940,0,9,Thursday,53,21,6,11,91,low
2941,0,9,Thursday,99,16,38,7,160,high
2942,0,9,Thursday,86,21,31,18,156,high
2943,0,9,Thursday,79,28,35,13,155,high
2944,0,9,Thursday,146,25,33,8,212,heavy
2945,0,9,Thursday,116,24,36,6,182,heavy
2946,0,9,Thursday,107,14,44,5,170,heavy
2947,0,9,Thursday,115,20,27,9,171,heavy
2948,0,9,Thursday,113,23,43,6,185,heavy
2949,0,9,Thursday,102,20,31,5,158,high
2950,0,9,Thursday,138,27,21,7,193,heavy
2951,0,9,Thursday,146,13,38,9,206,heavy
2952,0,9,Thursday,139,33,41,7,220,heavy
2953,0,9,Thursday,130,24,48,9,211,heavy
2954,0,9,Thursday,135,31,34,8,208,heavy
2955,0,9,Thursday,106,22,16,20,164,normal
2956,0,9,Thursday,109,23,14,26,172,heavy
2957,0,9,Thursday,108,24,19,10,161,normal
2958,0,9,Thursday,50,16,16,11,93,normal
2959,0,9,Thursday,102,22,17,10,151,normal
2960,0,9,Thursday,72,25,10,27,134,high
2961,0,9,Thursday,91,13,18,13,135,normal
2962,0,9,Thursday,67,19,11,8,105,low
2963,0,9,Thursday,61,14,10,5,90,low
2964,0,9,Thursday,107,13,14,28,162,high
2965,0,9,Thursday,91,5,12,34,142,high
2966,0,9,Thursday,106,18,13,27,164,high
2967,0,9,Thursday,107,14,10,18,149,normal
2968,0,9,Thursday,17,4,1,20,42,normal
2969,0,9,Thursday,11,4,1,30,46,normal
2970,0,9,Thursday,11,4,0,23,38,normal
2971,0,9,Thursday,16,3,1,36,56,normal
2972,0,9,Thursday,11,0,1,30,42,normal
2973,0,9,Thursday,15,4,1,25,45,normal
2974,0,9,Thursday,16,5,0,27,48,normal
2975,0,9,Thursday,14,3,1,15,33,normal
